（变体）夺取中枢=(Variant) Cephalon Capture
龙骑兵=Drakgoon
龙钥=Dragon Keys
龙钥=Dragon Key
龙舰骑兵=Drekar Trooper
龙舰重型机枪手=Drekar Heavy Gunner
龙舰追踪者=Drekar Seeker
龙舰轰击狂躁者=Drekar Manic Bombard
龙舰精英枪兵=Drekar Elite Lancer
龙舰狂躁者=Drekar Manic
龙舰枪兵=Drekar Lancer
龙舰恶徒=Drekar Hellion
龙舰弩炮=Drekar Ballista
龙舰开膛者=Drekar Eviscerator
龙舰屠夫=Drekar Butcher
龙舰天蝎=Drekar Scorpion
龙卷云风=Tornado
龙之侍刃=Dragon Nikana
齐柏伦飞船=Zeplen
黯然失色=Eclipse
默认架式=Default Stance
黑鸦=Corvas
黑暗地带防御=Dark Sector Defense
黑暗地带相关=Dark Sector Reference
黑暗地带生存=Dark Sector Survival
黑暗地带挖掘=Dark Sector Excavation
黑暗地带冲突=Solar Rail Conflict
黑暗地带=Dark Sectors
黑暗地带=Dark Sector
黏子=Latcher
黄金喉兽=Golden Maw
黄道碎裂=Zodiac Shred
黄蜂蜇刺=Hornet Strike
黄蜂Nyx头盔=Vespa Nyx Helmet
麦格努斯双枪=Akmagnus
麦格努斯=Magnus
鹰眼=Eagle Eye
鹰爪=Talons
鳄神=Sobek
鲮鲤剑=Pangolin Sword
鱼鹰=Osprey
魅影（配备）=Specter (Gear)
魅影（敌方）=Specter (Enemy)
魅影（友方）=Specter (Tenno)
魅影自由之战=Specters Of Liberty
魅影军团=Specter Regiment
魅影=Specter
鬣猫驯兽师=Hyekka Master
鬣猫=Hyekka
鬣狗群=Hyena Pack
高贵踏频=Noble Cadence
高爆弹=Bloomer
高斯Mag头盔=Gauss Mag Helmet
高效传输=Efficient Transferral
高射炮击=Flak Shot
高压粉碎=Fracturing Crush
高压电流=High Voltage
骤然正义=Sudden Justice
骑兵=Trooper
骇入=Hacking
驱除力场=Repelling Bastille
驱逐舰=Frigate
驱逐堕落者=Expel Corrupted
驱逐员=Comba
驱逐Infested=Expel Infested
驱逐Grineer=Expel Grineer
驱逐Corpus=Expel Corpus
驱散=Dispel
驱引金流恐鸟=Drover Bursa
驯象钩刃=ArchHookSword
驯象钩刃=Agkuza
马谢特砍刀亡魂=Machete Wraith
马谢特砍刀=Machete
马拉松=Marathon
饰物=Ornament
食人鱼噬咬=Biting Piranha
食人鱼=Pyrana
食人女魔=Ogris
飞逝熵数=Entropy Flight
飞行员=Aviator
飞航系统=Avionics
飞翔=Pahta
飞扬Prime=Hikou Prime
飞扬=Hikou
飞升技巧=Rising Skill
飞光荒疫=Shimmering Blight
飑风Frost头盔=Squall Frost Helmet
风起云涌=Rising Storm
风火飞轮=Fire Walker
风暴Volt头盔=Storm Volt Helmet
风扇=Fan
颜料包B=Color Pack Beta
颜料包A=Color Pack Alpha
颜料=Pigment
领袖=Pack Leader
预言者蓝图=Seer Blueprint
预言者枪管=Seer Barrel
预言者枪机=Seer Receiver
预言者=Seer
顽皮=Mischief
顺风=Tail Wind
项圈蓝图=Collar Blueprint
项圈扣=Collar Buckle
项圈扣=Buckle
项圈带=Collar Band
项圈带=Band
顶级掠食者=Apex Predator
顶天立地=Sure Footed
音波冲击=Sound Quake
鞭=Whip
靶场=Shooting Gallery
非晶态合金=Morphics
非晶变压器Prime=Primed Morphic Transformer
非晶变压器=Morphic Transformer
非凡技巧=Melee Prowess
静音=Silent
静音=Silence
静谧无踪=Hushed Invisibility
静电释放=Static Discharge
静电能量导引枪=Staticor
霰弹枪弹药转换Prime=Primed Shotgun Mutation
霰弹枪弹药转换Prime=Primed Shotgun Ammo Mutation
霰弹枪弹药转换=Shotgun Ammo Mutation
霰弹枪弹药搜集者=Shotgun Scavenger
霰弹枪增幅=Shotgun Amp
霰弹枪MOD=Shotgun Mods
霰弹枪=Shotgun
霰弹扩充=Ammo Stock
霰弹地雷=Shrapnel Mine
霜叶=Frostleaf
震荡波=Rippling Shockwave
震荡恐鸟=Shockwave MOA
震荡弹头=Concussion Rounds
震荡使=Conculyst
震撼冲拳=Seismic Palm
震地冲击=Heavy Impact
震动之拳=Quaking Hand
雷筒=Blunderbuss
雷电米特尔=Thundermiter
雷爆信标=Castanas
雷火=Thunderbolt
雷射瞄具=Laser Sight
雷克斯双枪Prime=Aklex Prime
雷克斯双枪=Aklex
雷克斯Prime=Lex Prime
雷克斯=Lex
零号病患=Patient Zero
零件=Components
雪崩进攻=Avalanche Offensive
雪崩=Avalanche
雌鹿=Hind
集团警报=Syndicate Alert
集团特工=Syndicate Operatives
集团商品=Syndicate Offerings
集团勋章=Syndicate Medallions
集团=Syndicates
集团=Syndicate
隼目=Hawk Eye
障碍训练场=Obstacle Course
隔离金流恐鸟=Isolator Bursa
隔热=Insulation
隐蔽之箭=Cloak Arrow
隐秘潜入包=Stealth Pack
隐形=Invisibility
隐密追踪=Stalk
随机应变=Quick Thinking
陷阱=Traps
陶瓷匕首=Ceramic Dagger
降速爆击=Critical Deceleration
降灵追猎者=Ninkondi
附肢寄生者斑纹外观=Zebra Paracyst
附肢寄生者=Paracyst
附注=Notes
附注=Note
阿若卡Prime坠饰=Aroka Prime Sugatra
阿耶檀识塑像=Ayatan Sculptures
阿耶檀识塑像=Ayatan Sculpture
阿特拉克斯=Atterax
阿提卡=Attica
阿塔克斯=Artax
阿卡塔=Arcata
阿克里德=Acrid
阴阳庭院=Yin Yang Garden
阴影=Shade Sentinel
阴影=Shade
防护型库狛=Raksa Kubrow
防御=Endless Defense Missions
防御=Endless Defense
防御=Defense
阋神星=Eris
间谍=Spy 2.0
间谍=Spy
闪避装甲=Armored Evade
闪耀助燃=Flash Accelerant
闪瞬=Blink
闪电迷彩包=Shock Camo Pack
闪击=Blitz
长柄武器=Polearm
长时苦难=Enduring Affliction
镰刀=Scythe
镜厅=Hall of Mirrors
镜像型库娃=Adarza Kavat
镖袋=Pouch
镓=Gallium
镀金真相=Gilded Truth
镀金外观组合包=Ormolu Skin Bundle
锯齿边缘=Serrated Edges
锯齿弹链=Sawtooth Clip
锯刃弹头=Serrated Rounds
锯刃=Jagged Edge
锦鲤池=Koi Pond
锤头=Head
锤=Hammer
锡斯特双枪=Dual Cestra
锡斯特=Cestra
锐卡斯=Ripkas
锐利刀刃=Sharpened Blade
锋月双斧=Dual Raza
链接=Link
铸造厂=Foundry
银白天灾=Argent Scourge
铝热焊弹=Thermite Rounds
铁钩手甲=Tekko
铁质装甲=Ferrite armor
铁质装甲=Damage 2.0/Ferrite Armor
铁甲冲锋=Ironclad Charge
铁氧体=Ferrite
铁格栅=Grate
铁晶磁轨炮=Ferrox
钻石皮肤=Diamond Skin
钢铁防线=Steel Meridian
钢铁纤维=Steel Fiber
钢铁凤凰=Iron Phoenix
钢铁充能=Steel Charge
钢化皮肤=Iron Skin
金缮武器外观组合包=KINTSUGI WEAPON SKIN COLLECTION
金星=Venus
金工火神亡魂=Vulkar Wraith
金工火神=Vulkar
金工火枪=Vulklok
金属纤维（守护）=Steel Fiber (Sentinel)
金属纤维=Metal Fiber
量子切割器突击队员=Quanta Ranger
量子切割器破坏者=Quanta Vandal
量子切割器=Quanta
野马双枪Prime=Akbronco Prime
野马双枪=Dual Broncos
野马双枪=Akbronco
野马Prime=Bronco Prime
野马=Bronco
野蛮压制=Savagery
野生库狛=Kubrow (Feral)
野生库狛=Feral Kubrow
野生=Wild
野猪Prime=Boar Prime
野猪=Boar
野火=Wildfire
重锤射击=Hammer Shot
重铁雨落=Mafic Rain
重装火力=Magnum Force
重装巨兽=Juggernaut Behemoth
重生Prime=Primed Regen
重生=Regen
重点防御=Focused Defense
重整态势=Recovery
重定向=Retarget
重型机枪手=Heavy Gunner
重型弹头=Heavy Warhead
重口径=Heavy Caliber
重力奇点拟成枪=Simulor
重创Prime=Primed Heavy Trauma
重创=Heavy Trauma
重击者=Thumper
重击手=Powerfist
重击巨锤Prime=Fragor Prime
重击巨锤=Fragor
释放=Unleashed
采集者=Extractor
采矿车=Mining Machine
酸性弹壳=Acid Shells
配置需求=System Requirements
配备=Equipment
邪恶蓄力=Corrupt Charge
避雷针=Lightning Rod
避难所=Haven
遥测钥匙=Telemetry Key
遥控视角镜头=Remote Observer
遗迹船导航座标=Nav Coordinates
遗迹船导航座标=Nav Coordinate
遗迹=Derelict
遗物=Relic
道场装饰=Decorations
道场=Dojo
速攻赋能=Arcane Strike
速度考验=Orokin Moon/Speed Test
速度窜升=Speed Drift
速射=Snap Shot
通量射线步枪超载=Flux Overdrive
通量射线步枪=Flux Rifle
通量Nova头盔=Flux Nova Helmet
通电刀刃=Galvanized Blade
通晓霰弹枪=Shotgun Savvy
选项=Settings
逆进恐鸟=Anti MOA
追随者MOD=Acolyte Mods
追随者=acolyte
追踪者=Seeker
追击Alad=The Hunt For Alad VV
追击=Pursuit
迷雾驱逐员=Fog Comba
迷雾扰敌员=Fog Scrambus
迷惑=Confusion
迷尘=Spellbind
迦伦提恩Prime=Galatine Prime
迦伦提恩=Galatine
连续冲击=Crash Course
连牙追袭=Homing Fang
连发点射=Burst Fire
远古融合核心=Ancient Fusion Core
远古治愈者=Ancient Healer
远古干扰者=Ancient Disruptor
远古干扰者=Ancient Disrupter
远古堕落者=Corrupted Ancient
远古剧毒者=Toxic Ancient
返老还童=Rejuvenation
近战连击数=Melee Combo Counter
近战武器=Melee Weapons
近战MOD=Melee Mods
近战=Melee 2.0
近战=Melee
过载护盾=Overshields
过载护盾=Overshield
过载弹匣=Burdened Magazine
过热射击=Fired Up
过激真相=Stinging Truth
过度延展=Overextended
迅速抽换=Twitch
迅敏视觉=Spry Sights
达曼坠饰=Daman Sugatra
达克拉Prime=Dakra Prime
达克拉=Dakra
辐射缴械=Irradiating Disarm
辐射伤害=Radiation Damage
辐射伤害=Damage 2.0/Radiation Damage
辐射=Radiation
辅助动力=Auxiliary Power
轻羽箭=Feathered Arrows
轻灵月神双枪=Aksomati
轻抚-激怒=Pacify &amp; Provoke
轻型艇=Dargyn
轰隆石者=Rumbled
轰击者=Bombard
轰击=Thumper (Elytron)
轮次=Rotation
转轮弹匣=Repeater Clip
转换=Transmutation
轨道飞行器模块=Orbiter Segments
轨道飞行器=Orbiter
躁狂=Mania
蹒跚龙钥=Hobbled Key
践踏加固=Reinforcing Stomp
跃浪好手=Adept Surge
超音波冲击枪=Sonicor
超速击杀=Dispatch Overdrive
超越推进=Hyperion Thrusters
超负荷=Overload
超级弹跳=Super Jump
超声波=Sonic Boom
赫利俄斯Prime=Helios Prime
赫利俄斯=Helios Sentinel
赫利俄斯=Helios
赫利俄光锤=Heliocor
赤红狂舞=Crimson Dervish
赤毒鬣猫驯兽师=Kuva Hyekka Master
赤毒骑兵=Kuva Trooper
赤毒重型机枪手=Kuva Heavy Gunner
赤毒追踪者=Kuva Seeker
赤毒轰击者=Kuva Bombard
赤毒要塞=Kuva Fortress
赤毒虹吸器=Kuva Siphon
赤毒胸甲=Kuva Chest Plate
赤毒绳结=Kuva Cord Sugatra
赤毒织巾=Kuva Braid
赤毒精英枪兵=Kuva Elite Lancer
赤毒盾枪兵=Kuva Shield Lancer
赤毒猛力爪兵=Kuva Powerclaw
赤毒爪喀驯兽师=Kuva Drahk Master
赤毒爪喀=Kuva Drahk
赤毒烈焰刀客=Kuva Flameblade
赤毒火焰轰击者=Kuva Napalm
赤毒滚子=Kuva Roller
赤毒洪潮=Kuva Flood
赤毒枪兵=Kuva Lancer
赤毒斗篷=Kuva Cloak
赤毒恶徒轻型艇=Kuva Dargyn
赤毒恶徒=Kuva Hellion
赤毒怒焚者=Kuva Scorch
赤毒弩炮=Kuva Ballista
赤毒开膛者=Kuva Eviscerator
赤毒库狛护甲=Kuva Kubrow Armor
赤毒库娃护甲=Kuva Kavat Armor
赤毒屠夫=Kuva Butcher
赤毒小丑=Kuva Jester
赤毒守卫者=Kuva Guardian
赤毒天蝎=Kuva Scorpion
赤毒=Kuva
赛德娜=Sedna
赏金猎人=Bounty Hunter
赋能萃聚器=Arcane Distiller
赋能=Arcane Enhancements
赋能=Arcane Enhancement
赋能=Arcane
资源数量加成=Resource Booster
资源掉落机率加成=Resource Drop Chance Booster
资源匣=Resource Cache
资源储藏舱=Resource Cache
资源储藏舱=Caches
资源=resources
资料库=Codex
资料师=Datalyst
费洛髂荚囊=Pherliac Pod
贯彻始终=Follow Through
贪婪吸引=Greedy Pull
贪婪=Ravenous
贪夺触角=Pilfering Swarm
货运线路=Freight Line
败兴虐杀=Buzz Kill
责难束缚=Condemn
豺狼=Jackal
谷神星=Ceres
谐韵节拍=Metronome
调节跳跃=Tempered Bound
调色板=Color Picker Extension
调整者=Regulator
诸葛连弩=Zhuge
诱饵=Decoy
语言=Language
语录=Quotes
详细信息=Stats
诡计赋能=Arcane Trickery
试炼=Trial
认知&amp;冲击=Ack &amp; Brunt
警报=Alerts
警报=Alert
警惕机群=Watchful Swarm
触角肆虐=Tentacle Swarm
触媒连动=Catalyzer Link
触发几率=status chance
解除武装=Radial Disarm
解除武装=Disarm
解毒剂=Antitoxins
解毒剂=Antitoxin (Gear)
角色=Characters
觉醒双枪=AkJagara
视差瞄具=Parallax Scope
觅心猎手=Heartseeker
覆写=Override
西诺斯Prime=Cernos Prime
西诺斯=Cernos
西塞罗危机=the Cicero Crisis
西伯利亚冰锤=Sibear
裸鳃刃=Cerata
装饰=Aesthetics
装填速度=Reload Speed
装填=Reload
裂隙漫游=Rift Walk
裂隙涌流=Rift Surge
裂隙洪流=Rift Torrent
裂隙位面=Rift Plane
裂罅倾向性=Riven Disposition
裂罅MOD=Riven Mods
裂缝打击=Rift Strike
被隐藏的信息=Hidden Messages
被遗弃的Orokin船只=Orokin Derelicts
被遗弃的Orokin船只=Orokin Derelict
被撤回的游戏内容=Retrieved Content
被动能力=Passives
被偷走的梦=Stolen Dreams
衰竭驱逐员=Sap Comba
衰竭扰敌员=Sap Scrambus
表演时间=Shotgun Spazz
表情动作=Emotes
补愈-致残=Mend &amp; Maim
行动策略=Tactics
行动模式=Behavior
行动代号：Ambulas重生=Operation: Ambulas Reborn
行刑者Zura=Zura
行刑者Vay=Vay MoltaMolta
行刑者Vay=Executioner Vay MoltaMolta
行刑者Reth=Reth
行刑者Nok=Nok
行刑者MOD=Executioner Mods
行刑者Harkonar=Harkonar
行刑者Gorth=Gorth
行刑者Gorth=Executioner Gorth
行刑者Garesh=Garesh
行刑者Dok=Dok ThulThul
行刑者=Executioners
行内区块模板=Inline-Block Cells
血色面纱=Red Veil
血色刃缘=Bleeding Edge
血色万柳=Bleeding Willow
血肢=Hema
血红=Sanguine
螺钻打击=Auger Strike
螺钉步枪Prime=Boltor Prime
螺钉步枪=Boltor
螺钉拐刃=Boltace
螺钉手枪=Bolto
螺钉双枪=Akbolto
融合核心=Fusion Core
融合=Fusion
蝰蛇=Viper
蝗虫无人机=Locust Drone
蝎尾狮重斧外观=Manticore
蜻蜓薙=Tonbo
蜜獾=Ratel
蜕皮=Molt
蜕化再生=Regenerative Molt
蛟龙Prime=Wyrm Prime
蛟龙=Wyrm Sentinel
蛟龙=Wyrm
蛔虫=Ascaris
蛇颚刀=Jaw Sword
蛇发女妖的狂热=Gorgon Frenzy
蛇发女妖亡魂=Gorgon Wraith
蛇发女妖=Gorgon
蛇刃=Sarpa
蛆虫=Maggot
蚂蟥=Hirudo
蚀骨寒霜=Vicious Frost
蚀能磁触=Sapping Reach
虫洞=Worm Hole
虚能船员=Nullifier Crewman
虚空钥匙=Void Keys
虚空钥匙=Void Key
虚空遗物=Void Relics
虚空遗物=Void Relic
虚空裂缝=Void Fissure
虚空商人=Void Trader
虚空冲刺=Void Dash
虚空光体=Void Traces
虚空之影=Void Shade
虚空=Void
虚无驱逐员=Nul Comba
虚无扰敌员=Nul Scrambus
虚弱动能=Frail Momentum
虚伪连接=Deceptive Bond
蓝图=Blueprints
蓝图=Blueprint
蓄能重划=Redirection
蓄力装填=Charged Chamber
葛拉卡达=Grakata
葛恩火枪=Grinlok
落银树庭=The Silver Grove
菲德菈枪机=Phaedra Receiver
菲德菈=Phaedra
荧惑=The Gradivus Dilemma
荒谬双枪=AkZani
苦难=Misery
苦行加护=Penance
苦无=Kunai
苏普拉破坏者=Supra Vandal
苏普拉=Supra
苍穹死神=Ether Reaper
苍穹双剑=Dual Ether
苍穹匕首=Ether Daggers
苍穹之剑=Ether Sword
芭丝特Valkyr头盔=Bastet Valkyr Helmet
节约套组=Frugal Credit Bundle
节日特供=Holiday Content
色彩包=Colour Picker Extension
色彩包=Color Palettes
船员=Crewmen
船员=Crewman
航道幽影=Specters of the Rail
致盲=Radial Blind
致病力=Virulence
致残突击=Maiming Strike
致残枪弹=Maim
致死加速=Fatal Acceleration
致命诱惑=Fatal Attraction
致命火力=Malignant Force
致命洪流=Lethal Torrent
致命数列=Deadly Sequence
致命匿杀=Covert Lethality
致命动量=Lethal Momentum
致命传送=Fatal Teleport
致命一击=Point Strike
至尊浪人=Sovereign Outcast
自爆虫=Carabus
自爆机=Nemes
自爆=Self Destruct
自动扳机=Automatic Trigger
自动=Auto
膛线=Serration
膛室Prime=Primed Chamber
腐败弹匣=Tainted Mag
腐蚀投射=Corrosive Projection
腐蚀弹幕=Corroding Barrage
腐蚀伤害=Damage 2.0/Corrosive Damage
腐蚀伤害=Corrosive Damage
腐蚀=Corrosive
腐蚀=Caustic
腐朽龙钥=Decaying Key
腐朽龙钥=Decaying Dragon Key
腐坏打击=Spoiled Strike
脱离速度=Escape Velocity
脓痘=Pox
脉冲震波=Repel
脉冲Volt头盔=Pulse Volt Helmet
能量运送者=Power Carrier
能量转换=Energy Conversion
能量转化=Energy Inversion
能量超载=Overcharged
能量虹吸=Energy Siphon
能量核心=Power Core
能量护罩=Energy Shell
能量扩散=Energy Amplifier
能量导引=Energy Channel
能量吸取=Energy Vampire
能量吸取=Energy Leech
能量力场=Energy Field
能量=Energy
能源实验室=Energy Lab
能力MOD与技能=Power Mods and Abilities
能力=Abilities
胸廓披饰=Thorac Syandana
背景知识=Lore
背景故事=Story and History
肾上腺激素=Adrenaline Boost
肢解=Organ Shatter
肉体=Flesh
肉体=Damage 2.0/Flesh
聚能焚炉=Thurible
聚精会神=Intensify
聚焦能量=Focus Energy
聚焦加速=Focused Acceleration
聚合物束=Polymer Bundle
联盟=Alliance
耗竭装填=Depleted Reload
耗弱链接=Abating Link
耐力MOD=Stamina Mods
耐力=Stamina
耐久强化=Enhanced Durability
翼膜=Patagium
翻筋斗=Handspring
翁=Okina
罗刹长柄武器外观=Rashasi Polearm Skin
罕见MOD=Uncommon Mods
罕见=Uncommon
缠旋风切=Stalking Fan
缓动惊骇=Creeping Terrify
综观全局=Overview
综合弹药箱=Omni Ammo Box
绯红西诺斯=Rakta Cernos
绯红暗黑匕首=Rakta Dark Dagger
绯红布里斯提卡=Rakta Ballistica
续燃=Afterburn
绝路=Rubico
绝望=Despair
绝壁强攻=Impenetrable Offense
结霜侵蚀=Frostbite
结算奖励=Completion Reward
结合扫描器=Synthesis Scanner
结合仪式=Synthesis
结为盟友=Ties That Bind
经验机制=Experience Mechanics
经验值加成=Affinity Booster
经验值=Affinity
经络Trinity头盔=Meridian Trinity Helmet
终结闪光=Radiant Finish
终结=Finishing
终结=Finisher
终焉风暴=Eleventh Storm
终极螺钉步枪=Telos Boltor
终极螺钉拐刃=Telos Boltace
终极螺钉双枪=Telos Akbolto
终末使者=Last Herald
细剑=Rapier
组合型房间=Organization Rooms
线圈Mag头盔=Coil Mag Helmet
纹章=Sigils
纹章=Sigil
纵火=Arson
纵横双子=Gemini Cross
纳米涂覆=Nano-Applicator
纳米孢子=Nano Spores
纳瑟斯毛皮花纹=Nexus Fur Pattern
纯净之风=Winds of Purity
纯净=Purity
红隼=Kestrel
红晶枪管=Rubedo-Lined Barrel
红化结晶=Rubedo
紧急后果=Emergent Aftermath
紧凑步伐=Hastened Steps
系绳榴弹=Tether Grenades
系统重划=System Reroute
系统蓝图=Systems Blueprint
系统蓝图=System Blueprint
系统=Systems
系统=System
系列任务=Quest
精英船员=Elite Crewman
精英沙漠枪兵=Elite Arid Lancer
精英枪兵=Elite Lancer
精英前线枪兵=Elite Frontier Lancer
精粹采集者Prime=Distilling Extractor Prime
精粹采集者=Distilling Extractor
精算蓄能=Redirection (Sentinel)
精算蓄能=Calculated Redirection
精算射击=Calculated Shot
精神飞刃=Psychic Bolts
精神狂怒=Mind Freak
精神控制=Mind Control
精灵之王魅影=Feyarch Specter
精湛快手=Soft Hands
精准火枪=Grinloked
精准弹跳=Calculated Spring
精准弹药=Precision Munition
精准度=Accuracy
粉碎器=Shredder
粉碎=Crush
类星钻体=Quasar Drill
米特尔=Miter
米尔=Mire
簧压膛室=Spring-Loaded Chamber
簧压猎箭=Spring-Loaded Broadhead
箭矢转换=Arrow Mutation
箭型弹头=Flechette
简化=Streamline
筋头游云=Cloud Walker
等级=rank
等离子长剑=Plasma Sword
等离子步枪=Plasma Rifle
第二场梦=The Second Dream
笑面型库娃=Smeeta Kavat
竞技场=Arena
站姿=Idle Animations
窟窿=Kotara
突触生化枪=Synapse
突袭=Rush (Archwing)
突斩=Slash Dash
突变原聚合物=Mutagen Mass
突击队员=Ranger
突击步枪MOD=Assault Rifle Mods
突击步枪=Assault Rifle
突击奖励=Sortie Reward
突击型库狛=Sahasa Kubrow
突击=Sortie
穿龙破=Through Strike
穿透力=Seeking Force
穿透=Punch Through (Mechanic)
穿透=Punch Through
穿甲口径=Piercing Caliber
穿甲伤害=Piercing Hit
穿刺步伐=Piercing Step
穿刺抛体=Piercing Navigator
穿刺弹药=Impaler Munitions
穿刺伤害武器=Puncture Damage Weapons
穿刺伤害=Damage 2.0/Puncture Damage
穿刺=Puncture
空尖弹=Hollow Point
空刃双刀=Dual Skana
空刃Prime=Skana Prime
空刃=Skana
空中支援呼叫器=Air Support Charges
空中支援呼叫器=Air Support Charge
空中推进=Air Thrusters
空中侦查=Air Recon
稳定枪手=Steady Hands
稳定=Stabilizer
稀有资源蓝图=Rare Resource Blueprint
稀有MOD=Rare Mods
稀有=Rare
移形换位=Switch Teleport
移动防御=Mobile Defense
移动速度=Movement Speed
积秽骁龙=Defiled Snapdragon
秘奥头盔=Arcane Helmet
科加基=Kogake
种类=Variations
秋风落叶=Tranquil Cleave
秃鹫空投艇=Condor Dropship
禁卫军=Guardsman
祸根=Scourge
神针腾跃=Iron Vault
神针突刺=Iron Jab
神经元=Neurodes
神经传感器=Neural Sensors
神枪手=Gunslinger
神圣领域=Hallowed Ground
神圣清算=Hallowed Reckoning
神器防御活动=Artifact Defense Event
神器=Artifact
祝福=Blessing
磨锋之爪=Sharpened Claws
磁轨炮恐鸟=Railgun MOA
磁浮=Maglev
磁吸释放=Magnetized Discharge
磁吸力场=Magnetize
磁力伤害=Magnetic Damage
磁力伤害=Damage 2.0/Magnetic Damage
磁力=Magnetic
碲=Tellurium
碎铁弹片=Iron Shrapnel
碎裂冲击=Shattering Impact
碎片=Fragments
破解器=Cipher
破裂装填=Breach Loader
破裂=Rupture
破碎的战争之剑=Broken-War
破碎的战争之剑=Broken War
破碎正义=Shattering Justice
破碎护盾=Shatter Shield
破碎声波=Sonic Fracture
破碎之风=Fracturing Wind
破碎Rhino包=Wrecking Rhino Pack
破甲=Sundering Strike
破片弹头=Shrapnel Rounds
破片射击=Shrapnel Shot
破灭Prime=Primed Ravage
破灭=Ravage
破损珽杖=Broken Scepter
破坏者=Vandal
破坏巨人战舰行动=Operation Sling-Stone
破坏巨人战舰=Sling-Stone Event
破坏型无人机=Disruptor Drone
破坏型无人机=Disrupter Drone
破坏=Sabotage
研究实验室=research lab
研究=Research
矿石凝视=Ore Gaze
石堆纪念碑=Cairn
石化凝视=Petrify
短柄战镰=Kama
短斧外观=Dagger Axe (Scindo)
矫捷考验=Orokin Moon/Agility Test
矫捷窜升=Agility Drift
瞬间命中=Hit-scan
瞬间冲击=Sudden Impact
瞬移=Teleport
瞬杀=Swift Deth
瞬时坚毅=Transient Fortitude
瞄准=aim
瞄准=Zoom
真相之刃=Blade of Truth
真相=Truth
真理巨剑=Veritux
真实惩罚=True Punishment
盾枪兵=Shield Lancer
相关图片=Gallery
相位魅影蓝图=Phase Specter Blueprint
盲目射击=Blind Shot
盲怒=Blind Rage
目盲=blind
目标感应=Targeting Receptor
盘旋鞭笞=Lashing Coil
盗贼天赋=Thief's Wit
盗贼大师=Master Thief
盗贼双枪=Afuris
盗贼=Furis
盖霜跳马=Rime Vault
监控摄像头=Security Camera
监工船员=Prod Crewman
盆栽=Planter
皇家节奏=Tempo Royale
皇家拐刃=Kronen
百折不挠=Constitution
白霜弹头=Rime Rounds
白金=Platinum
登陆艇铸造厂模组=Landing Craft Foundry Segment
登陆艇模块=Liset Segments
登陆艇=Landing Craft
登录奖励=Login Rewards
瘴气=Miasma
瘫痪强化=Prolonged Paralysis
瘫痪=Paralysis
瘟疫手枪=Pistol Pestilence
痛苦阈值=Pain Threshold
痉挛=Convulsion
痈裂者=Boiler
病毒伤害=Viral Damage
病毒=Viral
病变虫母=Brood Mother
病变=Lesion
病原弹头=Pathogen Rounds
疾风湍流=Turbulence
疾冲者=Charger
疗愈脉动=Renewal
疗愈漩涡=Curative Undertow
疏浚兵长=Darek Draga
疏浚兵=Draga
画龙点睛=Finishing Touch
男性=Males
电路=Circuits
电能斩锯=Serro
电磁脉冲场=EMP Aura
电磁屏障=Electromagnetic Shielding
电磁屏障=Electric Shield
电磁力场装置样本=Fieldron Sample
电磁力场装置=Fieldron
电流震击=Jolt
电流长矛=Voltaic Lance
电气浮囊=Diriga
电弧陷阱=Arc Trap
电弧线圈=Arc Coil
电容=Capacitance
电压数列=Voltage Sequence
电击震荡=Shock Trooper
电击触点=Shocking Touch
电击疏浚兵=Shock Draga
电击爬行者=Electric Crawler
电击棒=Stun Baton
电击加速=Shocking Speed
电击伤害武器=Electricity Damage Weapons
电击伤害=Electricity Damage
电击伤害=Electrical Damage
电击伤害=Electric Damage
电击伤害=Damage 2.0/Electricity Damage
电击=Shock
电击=Electricity
电击=Electric
电击=Discharge
电冲弹药=Shell Shock
电光脉冲=Electro Pulse
电光冲刺=Lightning Dash
甲龙双拳Prime=Ankyros Prime
甲龙双拳=Ankyros
生物质=Plastids
生物实验室=Biological Lab
生机赋能=Arcane Pulse
生存（活动）=Survival Weekend Event
生存=Survival
生命转换=Health Conversion
生命打击=Life Strike
生命回复（大）=Health Restore (Large)
生命力=Vitality
生命值连结=Link Health
生命之池=Pool of Life
生命之井=Well Of Life
生命=Health
瓦斯托Prime=Vasto Prime
瓦斯托=Vasto
珮菈坠饰=Pyra Sugatra
玻之武杖Prime=Bo Prime
玻之武杖=Bo
现金匣=Credits Cache
现金匣=Credit Cache
现金加成=Credit Booster
现金=credits
现金=Credit
玩家间对抗=PvP
玩家间对抗=Player vs. Player (PvP)
玩家创意=Community Concept
玛瑞火枪=Marelok
献灵=Tribute
猫眼=Cat's Eye
猛虎Prime=Tigris Prime
猛虎=Tigris
猛禽RX=Raptor RX
猛禽=Raptors
猛禽=Raptor
猛毒附加=Venom Dose
猛毒=Venom
猛扑=Pounce
猎豹=Panthera
猎杀型库狛=Sunika Kubrow
猎手外观=Huntsman Soma
猎人骨锯=Hunter's Bonesaw
狼鱼咬咬=Gnashing Payara
狼牙Prime=Fang Prime
狼牙=Fang
狭窄枪膛=Narrow Barrel
狩猎=Hunt
狡诈面貌=Cunning Aspect
狡诈考验=Orokin Moon/Cunning Test
狡诈窜升=Cunning Drift
狡狐诈面=Vulpine Mask
狙击特昂破坏者=Snipetron Vandal
狙击特昂=Snipetron
狙击枪弹药转换=Sniper Ammo Mutation
狙击枪弹药搜集者=Sniper Scavenger
狙击枪MOD=Sniper Mods
狙击枪=Sniper Rifles
狙击枪=Sniper Rifle
狙击手船员=Sniper Crewman
狂鲨=Tiberon
狂躁轰击者=Manic Bombard
狂躁Grineer=Manic
狂热火球=Fireball Frenzy
狂热打击=Fever Strike
狂暴追猎=Seeking Fury
狂暴尚武=Martial Fury
狂暴化=Rage
狂暴Prime=Primed Fury
狂暴=Fury
狂战士=Berserker
狂怒穿刺=Piercing Fury
狂怒标枪=Furious Javelin
狂怒=Furor
狂吼战拳=Roaring Drums
狂化突击=Hysterical Assault
狂化爆发（武器）=Hysteria (Weapon)
狂化爆发（架式）=Hysteria (Stance)
狂化爆发=Hysteria
狂化冲动=Hysterical Fixation
犀牛践踏=Rhino Stomp
犀牛冲锋=Rhino Charge
牺牲=Sacrifice
特殊武器=Special Weapons
特殊架式=Special Stance
特殊功能槽连接器=Exilus Adapter
特殊功能MOD=Exilus Mods
特斯拉陷阱=Tesla Link
特斯拉手榴弹=Tesla
特拉=Tetra
特性=Characteristics
物理伤害平均分配的武器=Balanced Physical Damage Weapons
物件=objects
物件=Object (Health)
物件=Object
物件=Damage 2.0/Object
牝狮神=Mios
片刻喘息=Momentary Pause
爱神之箭外观=Eros Arrow Skin
爬行者=Crawler
爪喀驯兽师=Drahk Master
爪喀=Drahk
爪刃=Blades
爆裂刀刃=Volcanic Edge
爆破计算=Measured Burst
爆燃安瓿=Detonite Ampule
爆燃喷射器=Detonite Injector
爆炸戏法=Explosive Legerdemain
爆炸奔跑者=Volatile Runner
爆炸伤害=Damage 2.0/Blast Damage
爆炸伤害=Blast Damage
爆散消亡=Explosive Demise
爆发赋能=Arcane Eruption
爆发装填Prime=Primed Fast Hands
爆发装填=Fast Hands
燃焰标枪=Javlok
燃烧弹头=Combustion Rounds
燃烧外壳=Incendiary Coat
熵数爆发=Entropy Burst
熵数尖钉=Entropy Spike
熵数=Entropy
熔岩无人机=Fusion Drone
熔岩恐鸟活动=Fusion Moa Event
熔岩恐鸟守卫=Fusion MOA Guardian
熔岩恐鸟=Fusion MOA
熔岩弹膛=Magma Chamber
熔岩冲击=Molten Impact
熄灭龙钥=Extinguished Key
焦虑=Angst
焚香容器=Incense Container
热诱弹=Disarray
热能产生器=Heat Generator
热磁弹药=Thermagnetic Shells
热熔炸弹=Moltecoil
烟幕=Smoke Screen
烈阳之焰=Solar Flare
烈焰风暴=Firestorm
烈焰长剑=Heat Sword
烈焰短剑=Heat Dagger
烈焰爆震=Firequake
烈焰欧格里斯=Pyrotechnic Ogris
烈焰双剑=Dual Heat Swords
烈焰刀客=Flameblade
烈焰=Blaze
炽燃钢铁=Searing Steel
炽烈坚刃=Blazing Steel
炼狱轰击=Scattering Inferno
炸药桶=Explosive Barrel
炮座壁垒=Rampart
炮塔=Turret
炮塔=Corpus Turret
炙热黄蜂=Burning Wasp
灾变连连=Cataclysmic Continuum
灾变=Cataclysm
灼蚀变体镰=Caustacyst
灼痕焦点=Scorch (Mod)
灼热跳跃=Searing Leap
灼热光束=Combustion Beam
灶神藓=Vestan Moss
灵魂重击=Soul Punch
灵活装甲=Armored Agility
灵枢=Orvius
灵敏扳机=Speed Trigger
灵快节拍=Deft Tempo
灭神Nyx头盔=Menticide Nyx Helmet
灭亡堕落者=Bane Of Corrupted
灭亡Infested=Primed Bane of InfestedPrime
灭亡Infested=Bane of Infested
灭亡Grineer=Primed Bane of GrineerPrime
灭亡Grineer=Bane of Grineer
灭亡Corpus=Primed Bane of CorpusPrime
灭亡Corpus=Bane of Corpus
火花=Spark
火绫守护=Safeguard
火绫复苏=Ward Recovery
火神闪击=Vulcan Blitz
火球=Fireball
火焰防护=Flame Repellent
火焰轰击者=Napalm
火焰装填Prime=Primed Heated Charge
火焰装填=Heated Charge
火焰行者=Firewalker
火焰冲击（Ruk）=Fire Blast (Ruk)
火焰冲击=Fire Blast
火焰伤害武器=Heat Damage Weapons
火焰伤害=Heat Damage
火焰伤害=Damage 2.0/Fire Damage
火焰=Heat
火海=World On Fire
火星=Mars
火成碎流=Pyroclastic Flow
火卫一=Phobos
濒死=Bleedout
激怒=Provoked
激冷装填=Chilling Reload
激光点发=Burst Laser
激光步枪Prime=Prime Laser Rifle
激光步枪=Laser Rifle
激光栅栏=Laser Barrier
潮汐涌净=Tidal Impunity
潮汐浪涌=Tidal Surge
潜影猎手=Prowl
潘塔突击队员=Penta Ranger
潘塔=Penta
漫步石者=Rumblers
漏洞=Bugs
漏斗状云=Funnel Clouds
漂移接触=Drifting Contact
滞缓驱逐员=Slo Comba
滞缓无人机=Temporal Dreg
滞缓扰敌员=Slo Scrambus
滞痕冰浪=Ice Wave Impedance
滚子哨兵=Roller Sentry
滚子=Roller
滑行时=Slide
滑行扫射=Strafing Slide
滑行=slide
滑索=zipline
溢能感应=Overcharge Detectors
溃散射击=Crash Shot
湮灭流星群=Null Star
游离双管=Double-Barrel Drift
游戏用语=Glossary
游戏模式=Game Modes
游戏机制=Mechanics
游戏人物=Characters
温暖赋能=Arcane Warmth
渗透=Infiltrate
清道夫无人机=Scavenger Drone
清巢行动=Operation Breeding Grounds
清巢=Hive Sabotage
清巢=Hive
混天火绫=Warding Halo
混乱领域=Chaos Sphere
混乱=Chaos
深红飓风=Scarlet Hurricane
深渊之火=Atlantis Vulcan
深海研究所破坏=Sealab Sabotage
深层冷冻=Deep Freeze
液压枪膛=Hydraulic Chamber
液压枪管=Hydraulic Barrel
液压弹药=Hydraulic Gauge
液压准心=Hydraulic Crosshairs
涡卷俯冲=Divebomb Vortex
涌流突进=Surging Dash
消音器=Hush
消音=Suppress
消耗=Cost
消歧义=Disambiguation
海王星=Neptune
海波斯库拉对剑=Nami Skyla
海波单剑=Nami Solo
海军陆战队中士=The Sergeant
海克=Hek
浮印光谱=Glyph Prism
浮印=Glyph
流线形体流线外形=Streamlined Form
流星撞击=Meteor Crash
流星弹药=Meteor Munitions
派系伤害MOD=Faction Damage Mods
派系=factions
派系=Faction
活泼静电=Static Alacrity
活动奖励=Event Reward
活动=Events
活动=Event
活力Prime=Primed Vigor
活力=Vigor
活体连接器=Somatic Link
泰斯拉末日=Tethra's Doom
泰坦采集者Prime=Titan Extractor Prime
泰坦采集者=Titan Extractor
泥炭萃取物=Nitain Extract
法典仪器=Arcane Machine
治疗=Healing
治愈归复=Healing Return
治愈之塔=Med Tower
沙皇=Zarr
沙漠鳐鱼=Desert Skate
沙漠骑兵=Arid Trooper
沙漠重型机枪手=Arid Heavy Gunner
沙漠重型机枪兵=Desert Heavy Gunner
沙漠追踪者=Arid Seeker
沙漠枪兵=Arid Lancer
沙漠恶徒=Arid Hellion
沙漠恐惧=Operation Arid Fear
沙漠恐惧=Arid Fear Event
沙漠开膛者=Arid Eviscerator
沙漠屠夫=Arid Butcher
沙涡之祭=Devour
沙土幽灵=Sand Shadow
沉默寡言的男人=A Man of Few Words
沉睡之箭=Sleep Arrow
沉没之爪=Sinking Talon
汽化=Vaporize
汲能榨取=Vampire Leech
污秽弹药=Tainted Shell
污染水螅=Tainted Hydra
污染弹匣=Infected Clip
求知组合包=Quaro Collection
永恒纯净=Lasting Purity
永恒痛苦=Perpetual Agony
永恒战意=Eternal War
永恒之护=Everlasting Ward
永动漩涡=Perpetual Vortex
永冻晶矿前线=Operation Cryotic Front
永冻晶矿=Cryotic
水雷无人机=Sikula
水漩涡=Undertow
水星=Mercury
氩结晶=Argon Crystal
氩晶装甲=Argon Plating
氩晶瞄具=Argon Scope
氚电池=Tritium Battery
氏族钥匙=Clan Key
氏族道场=Clan Dojo
氏族=Clan
比较=Comparisons
毒蛇螺旋=Coiling Viper
毒素注射器=Toxin Injector
毒素数列=Toxic Sequence
毒素抵抗=Toxin Resistance
毒素弹幕=Toxic Barrage
毒素伤害=Toxin Damage
毒素伤害=Damage 2.0/Toxin Damage
毒素=Toxin
毒素=Toxic
毒气伤害=Gas Damage
毒气伤害=Damage 2.0/Gas Damage
毒抗=Antitoxin (Mod)
毒性孢子=Spores
毒性孢子=Spore
毒囊双枪=Dual Toxocyst
毒刺=Stinger
每日献礼奖励=Daily Tribute Rewards
每日献礼=Daily Tribute
母舰=Carrier (Enemy)
母神的悲剧=Gaia's Tragedy
毁灭扩展=Ruinous Extension
毁灭弹头=Warhead
毁灭堕落者=Smite Corrupted
毁灭之眼=Operation Eyes of Blight
毁灭Infested=Smite Infested
毁灭Grineer=Smite Grineer
毁灭Corpus=Smite Corpus
毁坏毒素=Toxic Blight
毁坏微光=Gleaming Blight
毁坏=Blight
段位=Mastery Rank
段位=Mastery
残酷组合=Relentless Combination
残酷无息=Savage Silence
残酷打击=Relentless Assault
残血龙钥=Bleeding Key
残盾转换=Surplus Diverters
残暴浪潮=Brutal Tide
残响共鸣=Resonance
残余=Spare Parts
歼灭=Exterminate
歼夺=Annihilation
死命顽抗=Defy
死亡魔方=Dethcube Sentinel
死亡魔方=Dethcube
死亡标记=Death Mark
死亡机枪=Deth Machine Rifle
死亡使徒=Kaszas
死亡之眼=Dead Eye
死亡=Death
武装使=Battalyst
武形秘仪=Conclave
武器段位限制=Weapons Mastery Rank
武器强化MOD=Weapon Augment Mods
武器强化=Weapon Augments
武器外观=Weapon Skins
武器外观=Weapon Cosmetics
武器=weapon
武器=Weapons
步枪才能=Rifle Aptitude
步枪弹药转换Prime=Primed Rifle Mutation
步枪弹药转换Prime=Primed Rifle Ammo Mutation
步枪弹药转换=Rifle Ammo Mutation
步枪弹药搜集者=Rifle Scavenger
步枪增幅=Rifle Amp
步枪MOD=Rifle Mods
步枪=Rifles
正午=High Noon
正义刀锋=Justice Blades
正义=Justice
正中红心=Dead Aim
欺骗=Deception
欺幻魔灯=Beguiling Lantern
欧罗巴=Europa
欧玛=Ohma
欧特鲁斯Prime=Orthos Prime
欧特鲁斯=Orthos
次要开火模式=Secondary Fire
次要开火模式=Alternate Fire
模板=Templates
槌音铮鏦=Mallet
植物=Plants
棱镜=Prism
棱晶阴影=Prisma Shade
棱晶蛇发女妖=Prisma Gorgon
棱晶葛拉卡达=Prisma Grakata
棱晶纹章=Prisma Sigil
棱晶箭=Prisma Arrows
棱晶空刃=Prisma Skana
棱晶真理巨剑=Prisma Veritux
棱晶特拉=Prisma Tetra
棱晶激光点发=Prisma Burst Laser
棱晶机甲头盔面具=Prisma Mech Head Sentinel Mask
棱晶朔月女神披饰=Prisma Hecate Syandana
棱晶斩肉双刀=Prisma Dual Cleavers
棱晶奥比克斯=Prisma Obex
棱晶外观Liset=Prisma Liset Skin
棱晶喷射机翼=Prisma Jet Sentinel Wings
棱晶代达罗斯胸甲=Prisma Daedalus Chest Plate
棱晶代达罗斯护膝板=Prisma Daedalus Shin Guard
棱晶代达罗斯护肩=Prisma Daedalus Shoulder Guard
棱晶Yamako=Prisma Yamako
棱晶=Prisma
棱彩护卫=Prism Guard
森林-迷彩外观包=Forest-Camo Skin Pack
格挡=Parry
格挡=Blocking
格拉特勒=Grattler
格拉姆=Gram
核心通气=Core Vent
核心破坏=Reactor Sabotage
核心搬运恶徒=Hellion Power Carrier
样本突变原=Mutagen Sample
标记射击=Tracking Shot
标枪=Radial Javelin
架构=Schema
架式MOD=Stance Mods
架式=Stance
枯沙竭血=Desiccation
枪膛=Bore
枪管=Barrel
枪机=Receiver
枪托=Stock
枪口闪焰=Muzzle Flash
枪刃=Gunblade
枪兵=Lancer
枢议重力奇点拟成枪=Synoid Simulor
枢议赫利俄光锤=Synoid Heliocor
枢议咖玛腕甲枪=Synoid Gammacor
果断裁决=Decisive Judgement
构造裂缝=Tectonic Fracture
构造强化=Vitality (Sentinel)
构造强化=Enhanced Vitality
极限速度=Terminal Velocity
极限突破装置=Superchargers
极限突破装置=Supercharger
极限弹容=Maximum Capacity
极速电磁步枪=Velocitus
极速复原=Rapid Resilience
极恶精准=Vile Precision
极性=Polarity
极寒卓越者=Arctic Eximus
极寒=Arctic
极地弹仓=Polar Magazine
极地外观=Polar Glaxion
极化=Polarization
极光Frost头盔=Aurora Frost Helmet
松弛枪膛=Loose Chamber
松弛枪盖=Loose Hatch
松弛弹匣=Loose Magazine
杜卡德金币=Ducats
杖=Staff
杂技装甲=Armored Acrobatics
杀星=Kulstar
杀戳奖励=Prize Kill
杀伤计数=Body Count
机身=Fuselage
机翼蓝图=Wings Blueprint
机翼=Wings
机械=Machinery
机械=Damage 2.0/Machinery
机器=Robotic
机器=Damage 2.0/Robotic
机动装填=Tactical Reload
机动瞄准=Agile Aim
机动冲撞=Battering Maneuver
机制=Mechanics
机体蓝图=Chassis Blueprint
机体=Chassis
朱红风暴=Vermillion Storm
朱红风暴=Vermilion Storm
本质Loki头盔=Essence Loki Helmet
未完之刺=Lasting Sting
木质长椅=Wooden Bench
木星=Jupiter
有去无回=No Return
月落乌啼=Crushing Ruin
月神狩弓=Artemis Bow
月神Prime=Soma Prime
月神=Soma
月球=Lua
月动球=Lunaro
月光龙百合=Moonlight Dragonlily
月光玉叶=Moonlight Jadeleaf
月光去壳毬果=Moonlight Threshcone
月之猪笼草=Lunar Pitcher
最终先驱=Final Harbinger
最终一击=Final Tap
最大化=Maximized
最大化=Maximization
曼达和弦琴=Mandachord
更新记录=Patch History
更新历史=Patch History
更新=Updates
更新9=Update 9
更新8=Update 8
更新7=Update 7
更新21=Update 21
更新20=Update 20
更新19=Update 19
更新18=Update 18
更新17=Update 17
更新16=Update 16
更新15=Update 15
更新14=Update 14
更新13=Update 13
更新12=Update 12
更新11=Update 11
更新10=Update 10
曙光女神马刺Prime=Prime Eos Spurs
曙光女神胸甲Prime=Prime Eos Chest Plate
曙光女神肩甲Prime=Prime Eos Shoulder Plate
暴风雨弹幕=Tempest Barrage
暴风使者=Stormbringer
暴力=Violence
暴击机率=Crit Chance
暴击倍率=Crit Multiplier
暴击=Critical Hit (Mechanic)
暴击=Critical Hit
暮光药剂=Twilight Apothic
暗黑长剑=Dark Sword
暗黑匕首=Dark Dagger
暗黑分合剑=Dark Split-Sword
暗蚀计划=Project Undermine
暗杀者Prime=Sicarus Prime
暗杀者=Sicarus
暗影长剑亡灵节外观=Day of the Dead Dark Sword Skin
暗影步伐=Shadow Step
暗影收割=Shadow Harvest
暗夜追迹者=Night Stalker
暂息-怒气=Rest and Rage
暂息-怒气=Rest &amp; Rage
暂停=Pause
晶管屏障=Transistor Shield
普罗沃破坏者=Prova Vandal
普罗沃=Prova
显赫刀剑（架式）=Exalted Blade (Stance)
显赫刀剑=Exalted Blade
昼夜交替=Metamorphosis
星际航道=Solar Rails
星际航道=Solar Rail
星际战甲限时专享=Warframe China Timed Exclusive
星际战甲=Warframe China
星际战甲=WARFRAME (China)
星辰分裂=Star Divide
星界微光=Astral Twilight
星界剖解=Astral Autopsy
星球=Planets
星球=Planet
星标=Stars
星图=Starchart
星图=Star Chart
星体震荡=Cosmic Crush
星体切砍=Astral Slash
星云钻孔=Nebula Bore
日升药剂=Sunrise Apothic
日光龙百合=Sunlight Dragonlily
日光玉叶=Sunlight Jadeleaf
日光去壳毬果=Sunlight Threshcone
无赖魅影=Knave Specter
无电流飞跃=No Current Leap
无法在空中使用=Cannot Use In Air
无极魅影蓝图=Cosmic Specter Blueprint
无明制裁=Blind Justice
无尽苦难=Continuous Misery
无人机（Grineer空战）=Dreg
无人机（Corpus空战）=Attack Drone (Archwing Enemy)
无人机枪兵=Lancer Dreg
无人机守卫=Drone Guardian
无人机=Drone
无人机=Attack Drone
旋风虎击=Swirling Tiger
旋风=Whirlwind
旋涡=Vortex
旋棍=Tonfa
旋刃飞刀Prime=Spira Prime
旋刃飞刀=Spira
方位角=Azima
新疑谜团=The New Strange
新世间=New Loka
斯特朗亡魂=Strun Wraith
斯特朗=Strun
斯特拉迪瓦=Stradavar
斩铁=True Steel
斩肉双刀=Dual Cleavers
数据库模板=Database templates
数据块=Datamass
散射正义=Scattered Justice
救赎者镀铜外观=Elixis Redeemer
救赎者=Redeemer
救星诱饵=Savior Decoy
救援=Rescue 2.0
救援=Rescue
敌方行为=Enemy Behavior
敌方等级变化规律=Enemy Level Scaling
敌人身体部位=Enemy Body Parts
敌人武器=Enemy Weapon
敌人感应=Enemy Sense
敌人=Enemies
放逐=Banish
攻击速度=Attack Speed
改造器=Widget
收割螺旋=Reaping Spiral
收割者Prime=Reaper Prime
收割者=Reaper
操控=Maneuvers
操控=Maneuver
撤离=Evacuation
撕裂鹤击=Rending Crane
撕裂钩索=Rip Line
撕裂翻转=Rending Turn
撕裂打击=Rending Strike
撕裂弹头=Ripper Rounds
撕裂之风=Rending Wind
撕裂=Shred
撕碎射击=Shred Shot
摧毁传送门行动=Operation: Gate Crash
摧毁传送门行动=Operation Gate Crash
摆荡钩索=Swing Line
携带道具=Gear
搬运者Prime=Carrier Prime
搬运者=Carrier Sentinel
搬运者=Carrier
搜集=Scavenge
搜刮者=Looter
搏命反扑=Final Act
搏击=Sparring
握柄=Hilt
握柄=Handle
握柄=Grip
提问与解答=FAQ
提示=Tips
提奇鲁外观组合包=The Tekelu Collection
提佩多=Tipedo
推测=Speculation
控制模块=Control Module
接连件=Connector
接合点=Junction
探推-挽拉=Push &amp; Pull
掠夺=Despoil
掉落表=Drop Table
捶击=Maul
损害=Impair
捕获=Capture
挥击=Swipe
挖掘机=Excavator
挖掘=Excavation
挖掘=Dig
挑战奖励=Challenge Reward
挑战=Challenges
按键绑定=Key Bindings
按键组合=Button Combination
按住=Hold
指数之场MOD=Index Mods
指数之场=The Index
指挥官=Operator
指挥官=Commander
指导条例=Guided Ordnance
指导条例=Guided Ordinance
持续火力=Quickdraw
持续消耗型技能=Channeled Abilities
持久力Prime=Primed Continuity
持久力=Continuity
拳套=Gauntlet
拳套=Fist
拦截=Interception
招福=Charm
招式=Move
招募计划=Referral Program
拉特昂亡魂=Latron Wraith
拉特昂Prime=Latron Prime
拉特昂=Latron
拉斯波恩=Rathbone
拉托破坏者=Lato Vandal
拉托双枪=Aklato
拉托Prime=Lato Prime
拉托=Lato
抵近射击Prime=Primed Point Blank
抵近射击=Point Blank
抵消虫群=Negation Swarm
抬头显示界面=Heads-Up Display
披饰=Syandana
护盾鱼鹰=Shield Osprey
护盾速充=Quick Charge
护盾通量=Shield Flux
护盾连结=Link Shields
护盾连结=Link Shield
护盾过载=Shield Overload
护盾轻型艇=Shield Dargyn
护盾转移=Shield Transference
护盾瓦解=Shield Disruption
护盾极化=Shield Polarize
护盾极化=Polarize
护盾恶徒轻型艇=Shield-Hellion Dargyn
护盾回复=Shield Restore
护盾回复=Shield Restoration
护盾充能=Shield Charger
护盾=Shields
护盾=Shielded
护盾=Shield
护盾=Damage 2.0/Shielded
护盾=Damage 2.0/Shield
护甲连结=Link Armor
护甲=armour
护甲=Armor
护手=Guard
护卫舰=Corvette
护卫战机=Fighter Escort
护卫传送=Safeguard Switch
抛射物飞行速度MOD=Flight Speed Mods
抛射物飞行速度=Projectile Speed
抛射物飞行速度=Flight Speed
抚慰之风=Pacifying Bolts
折磨=Torment
抗血清注射器的碎片=Antiserum Injector Fragment
抗血清注射器=Antiserum Injector
抗爆覆甲=Anti-Flak Plating
抗性MOD=Resistance Mods
投枪=Speargun
投掷类武器=Thrown
技能范围最大化=Maximized Power Range
技能范围=Power Range
技能武器=Ability Weapons
技能效率最大化=Maximized Power Efficiency
技能效率=Power Efficiency (Mechanic)
技能效率=Power Efficiency
技能持续时间最大化=Maximized Power Duration
技能持续时间=Power Duration
技能强度最大化=Maximized Power Strength
技能强度=Power Strength
技能=Powers
技能=Abilities
技师=Tech
技巧之剑=Destreza
技工=Artificer
扰敌员=Scrambus
扬音守护配件=Ictus Attachments
扫除者Prime=Sweeper Prime
扫除者=Sweeper
扫荡锯齿=Sweeping Serration
扫描器=Codex Scanner
扫描=Scanner
扩散=spread
扩容弹夹=Magazine Extension
执法者=Magistar
执法员=Bailiff
托里德=Torid
打击乐=Percussion
手鼓=Pandero
手里剑=Shuriken
手枪精通Prime=Primed Pistol Gambit
手枪精通=Pistol Gambit
手枪弹药转换Prime=Primed Pistol Mutation
手枪弹药转换=Pistol Ammo Mutation
手枪弹药搜集者=Pistol Scavenger
手枪增幅=Pistol Amp
手枪MOD=Pistol Mods
战甲系统蓝图=Warframe Systems Blueprint
战甲机体蓝图=Warframe Chassis Blueprint
战甲技能=Warframe Abilities
战甲强化MOD=Warframe Augment Mods
战甲强化MOD=Warframe Augment Mod
战甲属性=Warframe Attributes
战甲对比=Warframes Comparison
战甲头盔蓝图=Warframe Helmet Blueprint
战甲外观=Warframe Cosmetics
战甲MOD=Warframe Mods
战甲=Warframes
战甲=Warframe
战术警报重现奖励周末=Tactical Recall Bonus Weekend
战术警报徽章=Stratos Emblem
战术警报奖励=Tactical Alert Reward
战术警报=Tactical Alert
战术箭袋=Quiver
战术性撤退=Tactical Retreat
战术上膛=Tactical Pump
战无不克=Vanquished Prey
战士=Warrior
战壕追逐=Trench Run
战吼=Roar
战利品探测器=Loot Detector
战刃原型外观=Proto-Glaive Skin
战刃Prime=Glaive Prime
战刃=Glaive
战争之剑=War
成长之力=Growing Power
戏法增幅=Trick Mag
戏法=Sleight Of Hand
憎恨=Hate
慑人神速=Stunning Speed
感染肌腱=Infested Sinew
感染肌腱=Damage 2.0/Sinew
感染肌腱=Damage 2.0/Infested Sinew
感染肉体=Infested Flesh
感染肉体=I. Flesh
感染肉体=Damage 2.0/Infested Flesh
感染肉体=Damage 2.0/I. Flesh
感染者阻抗=Infested Impedance
感染毒雾=Contagion Cloud
感染弹匣=Tainted Clip
感染巢囊=Infested Hive
感染=Damage 2.0/Infested
感应调整者=Sensor Regulator
感应条=Sensor Bar
感应条=Senser Bar
惩戒清算=Reckoning
惩戒=Retribution
惩击洗礼=Smite Infusion
惩击=Smite
惊骇=Terrify
惊惧热浪=Fire Fright
悲痛之刃=Lacera
悲剧的开端=Once Awake
悬丝之箭=Dashwire Arrow
悦音Prime=Euphona Prime
恶龙=Sydon
恶脓双斧=Dual Ichor
恶毒猛禽=Malicious Raptor
恶毒弹匣=Venomous Clip
恶毒=Venomous
恶怨厅=Hall of Malevolence
恶性扩散=Vicious Spread
恶徒轻型艇=Hellion Dargyn
恶徒=Hellion
恒稳枪杆=Gun Glide
恒久折磨=Lingering Torment
恐鸟储存柜=MOA Cabinet Spawner
恐鸟=MOA
恐惧=Dread
怯薜=Kesheg
怨恨=Malice
怨怒报复=Vexing Retaliation
怨怒护甲=Vex Armor
急速锋刃=Quick Steel
急速偏斜=Hastened Deflection
急速偏斜=Fast Deflection (Kubrow)
急进猛突=Blood Rush
急流=Jet Stream
急冻控场=Chilling Grasp
怒焚者=Scorch
快速收回=Quick Return
快速回复=Quick Rest
快速切换=Speed Holster
快速充能=Fast Deflection (Sentinel)
快速充能=Fast Deflection
快速休整=Brief Respite
忠实搭档=Loyal Companion
心眼=Martial Magnetism
心志偏狭=Narrow Minded
徽章=Emblem
德特昂苦痛=Mara Detron
德特昂苦痛=Detron Mara
德特昂船员=Detron Crewman
德特昂=Detron
德拉破坏者=Dera Vandal
德拉=Dera
微光利爪=Gleaming Talon
循环离子枪=Cycron
待更页面=Updateme
征服榴炮=Tonkor
影音资料=Media
影子之债=Operation: Shadow Debt
彩绘房间=Polychrome
彗星爆发=Comet Blast
彗星弹头=Comet Rounds
强音增幅=Amp
强袭=Assault
强化玻璃=Reinforced Glass
强化武器=Augmented Weapons
强化刀锋=Empowered Blades
强化刀片=Tempered Blade
强化MOD=Augmented Mods
强化MOD=Augment Mods
强化=Augments
强化=Augment
强力猛击=Pummel
弹鼓=Ammo Drum
弹道靶心=Ballistic Bullseye
弹道蓄能=Ballistic Battery
弹跳平台=Bounce
弹跳=Rebound
弹药转换MOD=Ammo Mutation Mods
弹药箱=Pistol_Ammo_Box
弹药箱=Pistol Ammo Box
弹药改良=Modified Munitions
弹药储转箱=Ammo Case
弹药=Ammo
弹指瞬技=Fleeting Expertise
弹头扩散=Barrel Diffusion
弹头导引=Seeker (Mod)
弹匣置换=Eject Magazine
弹匣容量MOD=Clip Size Mods
弹匣增幅=Magazine Warp
弱点感应=Vital Sense
弱点侦测=Detect Vulnerability
弱点专精Prime=Primed Target Cracker
弱点专精=Target Cracker
弩炮=Ballista
弧刃回天=Cleaving Whirlwind
弗拉克斯亡魂=Furax Wraith
弗拉克斯=Furax
引用=Sources
引用=References
引灵=Djinn Sentinel
引灵=Djinn
引擎=Engines
弓弦=String
弓MOD=Bow Mods
弓=Bow
异融量子枪=Mutalist Quanta
异融运输者鱼鹰=Mutalist Osprey Carrier
异融运输者鱼鹰=Mutalist Carrier Osprey
异融西诺斯=Mutalist Cernos
异融胞群恐鸟=Swarm-Mutalist MOA
异融胞群恐鸟=Swarm Mutalist MOA
异融者入侵=Operation: Mutalist Incursions
异融者Alad=Mutalist Alad VV
异融者Alad=Mutalist Alad V Assassinate KeyV刺杀钥匙
异融焦油恐鸟=Tar-Mutalist MOA
异融导航座标=Mutalist Nav Coordinate
异融=Mutalist
异常触发机率=Status Chance
异常状态=Status Effects
异常状态=Status Effect
异常状态=Status
异常状态=Proc
异况超量=Condition Overload
开膛者=Eviscerator
开关型技能=Toggled Abilities
延续组合包=Continuity Collection
延烧数列=Sequence Burn
延展=Extend
延伸=Stretch
应急备案=Plan B
应对技巧=Tactics
库狛蛋=Kubrow Egg
库狛外观=Kubrow Cosmetics
库狛取得任务=Howl of the Kubrow
库狛兽穴=Kubrow Den
库狛MOD=Kubrow Mods
库狛=Kubrow
库娃遗传密码=Kavat Genetic Code
库娃外观=Kavat Cosmetics
库娃初心者套装=Kavat Starter Kit
库娃MOD=Kavat Mods
库娃=Kavat
库娃=Feral Kavat
库利亚猫神器=Kuria
庇护烟幕=Smoke Shadow
庇护=Shelter
庇佑圣约=Covenant
广域之视=Broad Eye
幽灵=Ghost
幽暗枯竭=Draining Gloom
幽影之护=Shield of Shadows
幼体=Larva
幻雾魅影蓝图=Vapor Specter Blueprint
幻灯=Lantern
幻影装置存取密钥=Simulacrum Access Key
幻影装置=Simulacrum
幸运射击=Lucky Shot
幸存生灵=Soul Survivor
平衡配重=Counterweight
常见MOD=Common Mods
常见=Common
席芭莉丝Prime=Sybaris Prime
席芭莉丝=Sybaris
席瓦&amp;神盾Prime=Silva &amp; Aegis Prime
席瓦&amp;神盾=Silva &amp; Aegis
带电枪管=Electrified Barrel
帕里斯腐蚀外观=Abra Paris Skin
帕里斯Prime=Paris Prime
帕里斯=Paris
希芙=Sheev
布里斯提卡=Ballistica
布莱顿破坏者=Braton Vandal
布莱顿Prime=Braton Prime
布莱顿=Braton
布洛克战锤外观=Brokk
布拉克=Brakk
巴罗尔巨人战舰=Balor Fomorian
巴兹火枪=Buzlok
已绝版=Removed
巨浪拉克外观=Rahk Fluctus
巨浪=Fluctus
巨林冲击=Clashing Forest
巨大石者=Titanic Rumbler
巨刃=Heavy Blade
巨兽=Juggernaut
巨人战舰破坏=Fomorian Sabotage
巨人战舰干扰器=Fomorian Disruptor
巨人战舰=Formorian
巨人战舰=Fomorian
巨人促进剂=Fomorian Accelerant
川流不息Prime=Primed Flow
川流不息=Flow
嵴椎节鞭=Scoliac
崩毁浩劫=Crashing Havoc
峡谷殖民地=Canyon Settlement
山猫鱼鹰=Lynx Osprey
山猫炮塔=Lynx Turret
山猫=Lynx
屠戳换弹=Kill Switch
屠夫=Butcher
属性=Attributes
尸体=Corpse
尘光瓶子草=Dusklight Sarracenia
尖锐子弹=Sharpened Bullets
尖锐之风=Pointed Wind
尖牙连射=Fanged Fusillade
尖刃弹头=Bladed Rounds
小队=squad
小队=Cell
小常识=Trivia
小型医疗回复=Small Health Restore
射速MOD=Fire Rate Mods
射速=Fire Rate (Mechanic)
射速=Fire Rate
导路龙骸=Guided Effigy
导航阵列=Navigation Array
导航模板=Navbox
导航模块=Nav Segment
导热聚焦枪=Convectrix
导弹=Seeking Fire
导引MOD=Channeling Mods
导引=Channeling
导向抛体=Navigator
寻猎型库狛=Chesa Kubrow
对着倒地敌人=Aiming at Downed Enemy
寒流来袭=Cold Snap
寒冰之力=Freeze Force
寇恩霰机枪=Kohmak
寇恩热能枪=Kohm
寄生链接=Parasitic Link
寄生=Parasitic
寂静炮组=Silent Battery
宿命真理=Fateful Truth
宣传无人机=Propaganda Drone
宠物治疗套件=Medi-Pet Kit
定向汇聚=Directed Convergence
定位辅助=Targeting Subsystem
安格斯壮=Angstrum
安柏勒斯=Embolist
安培克斯=Amprex
守望者Prime=Vectis Prime
守望者=Vectis
守护金流恐鸟=Denial Bursa
守护配装=Sentinel Loadouts
守护者=Guardian
守护武器=Sentinel_Weapons
守护武器=Sentinel Weapons
守护恩典=Warding Grace
守护外观=Sentinel Cosmetics
守护光罩=Sanctuary (Mod)
守护MOD=Sentinel Mods
守护=Sentinels
守护=Sentinel
孵化器能量核心=Incubator Power Core
孵化器升级模块=Incubator Upgrade Segment
孵化器=Incubator
子弹磁石=Bullet Attractor
威胁等级=Threat Level
女性=Males
女性=Females
奥金之魂=Oro
奥米伽同位素=Omega Isotopes
奥秘=Arcane
奥比克斯=Obex
奥席金属鱼鹰=Oxium Osprey
奥席金属=Oxium
奥堤克光子枪=Opticor
奥努里克斯=Onorix
奚落守护=Guardian Derision
奖励系统=Reward System
奔跳者=Leaper
奔跑者=Runner
奋力一掷=Power Throw
奇特物件=Oddities
奇异点=Singularity
夺魂死神=Anku
夺取中枢=Cephalon Capture
头颅射击=Skull Shots
头部神经光元蓝图=Neuroptics Blueprint
头=Neuroptics
头部=Cerebrum
头脑风暴=Brain Storm
头目=Bosses
头目=Boss
头盔=Helmet
失衡护盾=Staggering Shield
太阳系=Sol
天顶之星=Zenistar
天赋=Natural Talent
天蝎=Scorpion
天穹之顶=Zenith
天界黄昏=Celestial Nightfall
天王星=Uranus
天才=Genius
天启异象=Four Riders
大砍刀=Machete
大型团队能量回复=Large Team Energy Restore
大型团队护盾回复=Large Team Shield Restore
大型团队弹药回复=Large Team Ammo Restore
大型团队医疗回复=Large Team Heal Restore
大地构筑=Tectonics
大久和弓=Daikyu
夜景武器外观组合包=NOCTURNE WEAPON SKIN COLLECTION
夜幕药剂=Nightfall Apothic
夜巡者枪兵=Nightwatch Lancers
夜巡者伪装迷彩=Nightwatch Camouflage
夜巡燃烧弹=Nightwatch Napalm
夜巡掠夺者=Nightwatch Reaver
多重射击=Multishot (Mechanic)
多重射击=Multishot
多流抽击=Flailing Branch
多方交战=Crossfire
多形态武器=Hybrid
外观=Skins
外观=Cosmetics
外甲蓝图=Harness Blueprint
外甲=Harness
外太空=Free Space
外壳=Carapace
复原装甲=Armored Recovery
复制肉体=Damage 2.0/Cloned Flesh
复制肉体=Cloned Flesh
复仇者赋能=Arcane Avenger
复仇真相=Avenging Truth
复仇法则=The Law of Retribution
复仇冲动=Vengeful Rush
复仇亡灵=Vengeful Revenant
复仇=Revenge
处决伤害=Finishing Damage
处决伤害=Damage 2.0/Finishing Damage
处决=Finisher
声纳=Sonar
声望=Standing
增幅线圈=Reflex Coil
增压弹匣=Pressurized Magazine
墙跑时=Wallrun
填弹加速=Shell Rush
填弹上膛=Lock and Load
塞诺德披饰=Synoid Syandana
塔克桑=Taxon
堡垒破坏=Orokin Sabotage
堡垒=Tower
堕落重型机枪手=Corrupted Heavy Gunner
堕落轰击者=Corrupted Bombard
堕落虚能者=Corrupted Nullifier
堕落船员=Corrupted Crewman
堕落者=Corrupted
堕落的Vor=Corrupted Vor
堕落的Vor=Captain Vor (Corrupted)
堕落枪兵=Corrupted Lancer
堕落恐鸟=Corrupted MOA
堕落屠夫=Corrupted Butcher
堕落典狱长=Corrupted Warden
堕落MOD=Corrupted Mods
基蚀鱼鹰=Sapping Osprey
基因密码模板=Genetic Code Template
埋伏射击=Lie In Wait
垂死挣扎=Mortal Conduct
坠饰=Sugatra
坚忍考验=Orokin Moon/Endurance Test
坚忍窜升=Endurance Drift
坚强崛起=Rising Steel
坚守=Stand Ground
均衡点=Equilibrium
均衡仲裁者=Arbiters of Hexis
场景武器=Emplacement Weapons
地面拼花=Floor Plate
地震波=Seismic Shockwave
地雷鱼鹰=Mine Osprey
地球=Earth
地狱火=Hellfire
地狱弹膛=Hell's Chamber
地毯式轰炸=Carpet Bomb
地图板块=Tilesets
地图板块=Tileset
地图板块=Tile Sets
地图板块=Tile Set
在空中=In Air
圣祷披饰=Officium Syandana
圣甲虫群=Scarab Swarm
圣火尖枪=Divine Spears
圣洁雷爆信标=Sancti Castanas
圣洁猛虎=Sancti Tigris
圣洁执法者=Sancti Magistar
圣殿=Sanctuary (Cephalon Simaris)
圣域爆发=Hallowed Eruption
土石塌方=Landslide
土星=Saturn
圆盘=Disc
团队能量回复=Team Energy Restore
团队歼夺=Team Annihilation
团队护盾回复=Team Shield Restore
团队弹药回复=Team Ammo Restore
团队回复用消耗品=Team Bonus Consumables
团队医疗回复=Team Heal Restore
团队医疗=Team Heal
团结一致=Stand United
回气再起=Secondary Wind
回收金属=Salvage
嚎声=Howl
噬菌者=Phage
噪音等级=Noise Level
噩梦模式=Nightmare Mode
噩梦MOD=Nightmare Mode Mods
噩梦=Nightmare
嗅索取物=Retrieve
喷射战锤=Jat Kittag
喷吐爬行者=Lobber Crawler
喧扰之箭=Noise Arrow
喀婆萨Prime项圈=Kavasa Prime Collar
喀婆萨Prime=Kavasa Prime
啐沫者=Tysis
商店=Market
啃咬压制=Neutralize
哈库那瞄准镜=Harkonar Scope
哈库那武器外观组合包=Harkonor Weapon Skin Collection
哈帕克=Harpak
哈利卡=Halikar
咬碎=Bite
咖玛腕甲枪=Gammacor
和平者之叛=The Pacifism Defect
和平挑衅=Peaceful Provocation
和平使者=Peacemaker
咆哮=Warcry
呕心爬行者=Nauseous Crawler
吸血鱼鹰=Leech Osprey
吸血=Leech
吸收=Absorb
吸引=Pull
吸取=Vacuum
启示研究室=Oracle Room
吞天沙暴=Sandstorm
后纪=Axi
后坐力=Recoil
后世纪=Axi Era
同化=Assimilate
同伴=Companions
同伴=Companion
合金钻头=Metal Auger
合金装甲=Damage 2.0/Alloy Armor
合金装甲=Alloy Armor
合金板=Alloy Plate
合成燃气炮=Cyngas
合成武器=Hybrid Weapons
合成刺激质=Synthula
史特克=Stug
史提托双枪Prime=Akstiletto Prime
史提托双枪=Akstiletto
可疑的货物=Suspicious Shipments
可由转换获取的MOD=Transmutable Mods
可用于铸造的武器=Weapons Required as Crafting Ingredients
可拾取物=Pickups
可拾取物=Pickup
另见=See also
古纪=Lith
古世纪=Lith Era
叛逃=Defection
变造利益=Operation False Profit
受损的MOD=Damaged Mods
受损=damaged
发射感染孢子=Attack Multalist
发射器=Launchers
反物质释放=Antimatter Drop
反物质地雷=Antimatter Mine
反物质吸收=Antimatter Absorb
反射（库娃）=Reflect
反射防御=Reflex Guard
反射拔枪=Reflex Draw
反射=Reflection
反击处决=Counterattack finisher
反击处决=Counterattack Finishers
双重连击=Double Tap
双重弹头=Dual Rounds
双蛇牙突=Crossing Snakes
双节尺棍=Shaku
双簧管=Tenora
双短柄战镰Prime=Dual Kamas Prime
双短柄战镰=Dual Kamas
双短斧外观=Dagger Axe (Zoren)
双爪=Claws
双持瓦斯托=Akvasto
双持副武器=Dual Sidearms
双手技能=Two-Handed Abilities
双截棍=Nunchaku
双属性MOD=Dual Stat Mods
双子蝰蛇亡魂=Wraith Twin Vipers
双子蝰蛇亡魂=Twin Wraith Vipers
双子蝰蛇=Twin Vipers
双子葛拉卡达=Twin Grakatas
双子葛拉卡达=Twin Grakata
双子罗格=Twin Rogga
双子巴萨克=Twin Basolk
双子小精灵=Twin Gremlins
双子宼恩霰机枪=Twin Kohmak
双子侍刃刀鞘=Gemini Nikana Sheath
双头蛇=Amphis
双匕首=Dual Daggers
双剑=Dual Swords
原木冲击=Crashing Timber
原子矿融炮=Atomos
原始狂怒=Primal Fury
原始暴怒=Primal Rage
原型护盾=Proto Shield
原型护盾=Damage 2.0/Proto Shield
原力魅影蓝图=Force Specter Blueprint
压迫点Prime=Primed Pressure Point
压迫点=Pressure Point
压轴好戏=Grand Finale
压缩弹壳=Shell Compression
卸能打击=Discharge Strike
危机感知=Sense Danger
危机=Environmental Hazards
卫星冲击无人机=Orbital Strike Drone
卡拉克亡魂=Karak Wraith
卡拉克=Karak
博多披饰=Bodo Syandana
单持副武器=Single Sidearm
单手技能=One-Handed Abilities
单手动作=One-Handed Action
单发=Single-Shot
卓越防御=Superior Defenses
卓越者=Eximus
卑劣加速=Vile Acceleration
协助Darvo=A Favor For Darvo
协力考验=Orokin Moon/Collaboration Test
协力窜升=Coaction Drift
华彩刀剑=Chromatic Blade
半自动=Semi-Automatic
半自动=Semi-Auto
半影屏蔽=Penumbra
半人马=Centaur
升龙拳=Launching Spring
千刀万剐=One Thousand Cuts
匿踪考验=Orokin Moon/Stealth Test
匿踪窜升=Stealth Drift
匿踪型库狛=Huras Kubrow
医疗射线=Medi-Ray
医疗回复=Health Restore
北风=North Wind
北海巨妖=Kraken
化石=Fossilized
化石=Damage 2.0/Fossilized
化学实验室=Chemical Lab
化像之道=Path of Statues
匕首=Dagger
匍匐靶心=Creeping Bullseye
勒克塔=Lecta
勇气玛瑞火枪=Vaykor Marelok
勇气海克=Vaykor Hek
勇气披饰=Vaykor Syandana
勇气恶龙=Vaykor Sydon
劫持=Hijack
努寇微波枪=Nukor
助燃=Accelerant
动能碰撞=Kinetic Collision
动能吸收陷阱=Kinetic Siphon Traps
动能吸收陷阱=Kinetic Siphon Trap
动物本能=Animal Instinct
动力回弹=Kinetic Ricochet
劣势=Disadvantages
加速冲击=Accelerated Blast
加速充能=Accelerated Deflection
加速=Speed
加速=Quickening
加载弹容=Loaded Capacity
加扎勒反曲刀=Gazal Machete
加成物品=Boosters
加成物品=Booster
加力燃烧=Afterburner
加剧反射=Heightened Reflexes
力量考验=Orokin Moon/Power Test
力量窜升=Power Drift
力场牢狱=Bastille
副武器=Secondary Weapons
副手霰弹枪=Shotgun Sidearm
剧毒飞腾=Toxic Flight
剧毒鞭苔=Toxic Slash
剧毒鞭苔=Toxic Lash
剧毒螯刺=Poisonous Sting
剧毒爬行者=Toxic Crawler
剧毒灾害=Virulent Scourge
剧毒无人机=Mutalist Osprey
剧毒升腾=Venomous Rise
剑风Prime=Primed Reach
剑风=Reach
剑鞭=Blade and Whip
剑盾=Sword and Shield
剑刃风暴=Blade Storm
剑=Sword
前锋=Striker
前线骑兵=Frontier Trooper
前线重型机枪手=Frontier Heavy Gunner
前线追踪者=Frontier Seeker
前线调整者=Frontier Regulator
前线枪兵=Frontier Lancer
前线恶徒=Frontier Hellion
前线开膛者=Frontier Eviscerator
前线屠夫=Frontier Butcher
前纪=Meso
前世纪=Meso Era
削甲手里剑=Seeking Shuriken
剃刀弹药=Razor Munitions
剃刀射击=Razor Shot
剃刀之翼=Razorwing
刺骨战吼=Piercing Roar
刺激剂=Stims
刺杀=Assassination
刺客=Assassin
利欲龙骸=Effigy
判官=Prosecutor
初来乍到箭矢组合包=Adventus Arrow Collection
创建者=Founders
创口溃烂=Weeping Wounds
刑罚Valkyr头盔=Kara Valkyr Helmet
切割刃缘=Cutting Edge
切割伤害武器=Slash Damage Weapons
切割伤害=Slash Damage
切割伤害=Damage 2.0/Slash Damage
切割=Slash
分裂膛室=Split Chamber
分裂编织=Sundering Weave
分裂斩斧Prime=Scindo Prime
分裂斩斧=Scindo
分裂之刃=Dividing Blades
分离Prime=Deconstructor Prime
分离=Deconstructor
分子转化=Molecular Conversion
分子填充=Molecular Prime
刀锋弹舞=Bullet Dance
刀刃=Blade
击倒=Knockdown
出血=Bleed
凶恶途径=Vicious Approach
凶恶终结=Ferocity
凶恶延伸=Sinister Reach
凯洛斯特=Karyst
凯旋将军破坏者=Imperator Vandal
凯旋将军=Imperator
凯旋之爪Prime=Venka Prime
凯旋之爪=Venka
凤凰新生=Phoenix Renewal
凝胶爆破=Adhesive Blast
减震器=Shock Absorbers
准确射手=Sure Shot
净化烈焰=Purifying Flames
净化斩=Purging Slash
净化堕落者=Cleanse Corrupted
净化Infested=Cleanse Infested
净化Grineer=Cleanse Grineer
净化Corpus=Cleanse Corpus
冻结=Freeze
冷面狂怒=Grim Fury
冷静与疯狂=Calm &amp; Frenzy
冷却液外泄=Coolant Leak
冷冻光束步枪=Glaxion
决斗房=Dueling Room
决斗=Duel
冲刺提升=Sprint Boost
冲刺=Rush
冲击预感=Anticipation
冲击干扰=Disruptor
冲击巨力=Collision Force
冲击伤害武器=Impact Damage Weapons
冲击伤害=Damage 2.0/Impact Damage
冲击=Impact
冰风暴=Ice Storm
冰雪护罩=Snow Globe
冰浪=Ice Wave
冰封护罩=Chilling Globe
冰冻伤害武器=Cold Damage Weapons
冰冻伤害=Ice Damage
冰冻伤害=Freeze Damage
冰冻伤害=Damage 2.0/Cold Damage
冰冻伤害=Cold Damage
冰冻=Cold
冰冷雪崩=Icy Avalanche
冰冷跃动=Ice Spring
冰冷疾风=Frigid Blast
冰冷刃缘=Glacial Edge
冬日组合包=Winter Bundle
冥王星=Pluto
军械库=Arsenal
再起=Second Wind
再生分流=Vital Systems Bypass
再启动鱼鹰=Remech Osprey
内融核心=Endo
内置触媒=Embedded Catalyzer
内置炸药=Concealed Explosives
内测=Closed Beta
内战=The War Within
典狱长=Warden
关键延迟=Critical Delay
共鸣渲染=Resonator
共鸣地震=Resonating Quake
兰花魅影=Orphid Specter
兰卡=Lanka
全面驱动=Mobilize
全面接触=Full Contact
全视使=Oculyst
全蚀=Total Eclipse
全自动=Automatic
入手方法=Acquisition
入侵者=Intruder
入侵=invasion
克那克斯=Knux
克洛诺斯=Cronus
光谱切割器=Spectra
光芒四射=Starburst
光环=Auras
光环=Aura
光环=Aruas
光棍=Light Staff
光暴怒吼=Spectral Scream
光明纯净=Bright Purity
充量弹容=Full Capacity
充能电幕=Recharge Barrier
充电弹头=Charged Shell
充沛赋能=Arcane Energize
元素沙暴=Elemental Sandstorm
元素伤害=Elemental Damage
元素之护=Elemental Ward
催泪毒雾=Tear Gas
储梦池=Reservoir
储存箱=Storage Crate
储存箱=Crate
储存柜=Locker
储存容器=Storage Containers
储存容器=Storage Container
偷袭技能=Stealth Abilities
偷袭处决=Stealth Finishers
偷袭=Stealth
停靠间=Docking Bay
停滞=Stasis
俯冲轰炸=Dive Bomb
信标=Beacons
信号闪光=Signal Flare
保障锡斯特双枪=Secura Dual Cestra
保障潘塔=Secura Penta
保障勒克塔=Secura Lecta
保温服=Warm Coat
保护=Protect
便携掩体=Blunt
侵蚀毁坏=Eroding Blight
侵略领土=Territorial Aggression
侦敌雷达=Enemy Radar
侦察=Investigator
侍刃“龙”外观=Ryu Nikana Skin
侍刃Prime=Nikana Prime
侍刃=Nikana
佩章雕塑=Insignia Sculpture
佩兰数列=The Perrin Sequence
佩兰数列=Perrin Sequence
体魄=Physique
佐伦双斧=Dual Zoren
低能耗飞跃=Low Current Leap
低温弹头Prime=Primed Cryo Rounds
低温弹头=Cryo Rounds
伯斯顿Prime=Burston Prime
伯斯顿=Burston
伤害MOD=Damage Mods
伤害=damage
伤害=Damage 2.02.0
伤害=Damage 2.0
传说核心=Legendary Core
传说MOD=Legendary Mods
传识之间=Transference Room
传染蔓延=Contagious Spread
传染=Contagion
伙伴=Partner
伏打电能=Voltaic Strike
伏击光子=Ambush Optics
伊格尼斯亡魂=Ignis Wraith
伊格尼斯=Ignis
任务奖励=Mission Rewards
任务=missions
任务=Mission
仁慈诱饵=Benevolent Decoy
什长双枪=Dual Decurion
人群驱散=Crowd Dispersion
亵渎清算=Defiled Reckoning
亵渎=desecrate
交易系统=Trade System
交易站=Trading Post
交易=Trading
交易=Trade
亡魂=Wraith
亡者幽影=Shadows of the Dead
亡灵节武器外观=Day of the Dead Weapon Skin Pack
互动型房间=Interactive Rooms
云暴山碎=Shattering Storm
二元性状=Duality
乾坤火圈=Blazing Chakram
乱入头目=Field Bosses
乱入头目=Field Boss
乏能迅敏=Anemic Agility
主页=HomePage
主武器=Primary Weapons
串联弹匣Prime=Primed Slip Magazine
串联弹匣=Slip Magazine
中继站=Relay
中纪=Neo
中空子弹=Hollowed Bullets
中枢苏达=Cephalon Suda
中枢Simaris=Simaris
中枢Simaris=Cephalon Simaris
中枢Sark=Cephalon Sark
中枢=Cephalon
中子星爆=Neutron Star
中型团队能量回复=Medium Team Energy Restore
中型团队护盾回复=Medium Team Shield Restore
中型团队弹药回复=Medium Team Ammo Restore
中型团队医疗回复=Medium Team Heal Restore
中世纪=Neo Era
丧钟=Knell
专精晶体=Focus Lens
专精=Focus
不朽打击=Enduring Strike
不朽意志=Undying Will
不屈不挠=Fortitude
不可由转换获取的MOD=Untransmutable Mods
下弓臂=Lower Limb
上弓臂=Upper Limb
上升打击=Soaring Strike
三重连击=Triple Tap
三幂之力=Power of Three
三叶坚韧=Endura
一掷千金套组=High Roller Credit Bundle
一剑在手=Sword Alone
一击必杀=Killing Blow
Zenurik极性MOD=Zenurik Mods
Zanuka计划=Zanuka Project
Zanuka猎犬=Zanuka Hunter
Xiphos飞航系统蓝图=Xiphos Avionics Blueprint
Xiphos机身蓝图=Xiphos Fuselage Blueprint
Xiphos引擎蓝图=Xiphos Engines Blueprint
Vor的战利品=Vor's Prize quest
Vor的战利品=Vor's Prize
Vor上尉=Captain Vor
Vazarin转换核心=Vazarin Transmute Core
Vazarin极性MOD=Vazarin Mods
Vay=Vay Hek Terra FrameHek地球外装战甲
Vay=Councilor Vay HekHek议员
Vauban镇压者外观=Vauban Suppressor Skin
Vauban精神病外观=Nyx Saikou Skin
Valkyr璀璨外观=Valkyr Gersemi Skin
Titania至点外观=Titania Solstice Skin
Tenno实验室=Tenno Research Lab
Tenno实验室=Research/Tenno Lab Research Tab
Tennogen武器外观组合包=Tennogen Weapon Skin Bundle
Sukira=Sukira Prime SyandanaPrime披饰
Simaris外观赫利俄斯=Simaris Helios Skin
Sentient=Sentients
Saryn铁杉头盔=Hemlock Saryn Helmet
Saryn兰花外观=Saryn Orphid Skin
Sargas=General Sargas RukRuk将军
Ruk之爪=Ruk's Claw
Rhino震击头盔=Thrak Rhino Helmet
Rhino先锋头盔=Vanguard Rhino Helmet
Regor的实验体=Operation: Tubemen of Regor
Regor的实验体=Operation Tubemen of Regor
Rathuum直播者=Rathuum Broadcaster
PvP用MOD=PvP Mods
Prime特权=Prime Access
Prime版MOD=Primed Mods
Prime宝库=Prime Vault
Penjaga极性MOD=Penjaga Mods
Orokin遗迹防御=Orokin Derelict Defense
Orokin遗迹移动防御=Orokin Derelict Mobile Defense
Orokin遗迹破坏=Orokin Derelict Sabotage
Orokin遗迹生存=Orokin Derelict Survival
Orokin遗迹歼灭=Orokin Derelict Exterminate
Orokin遗迹捕获=Orokin Derelict Capture
Orokin遗迹刺杀=Orokin Derelict Assassinate
Orokin语=Orokin Language
Orokin观察使=Orokin Spectator
Orokin虚空=Orokin Void
Orokin电池=Orokin Cell
Orokin炮塔=Orokin Turret
Orokin无人机=Orokin Drone
Orokin实验室=Orokin Lab
Orokin宝库=Orokin Vault
Orokin堡垒=Orokin Tower
Orokin反应堆=Orokin Reactor
Orokin催化剂=Orokin Catalyst
Orokin之月=Orokin Moon
Octavia的赞歌=Octavia's Anthem
Octavia华彩乐章头盔=Octavia Cadenza Helmet
Oberon精灵之王外观=Oberon Feyarch Skin
Nidus朊毒头盔=Nidus Prion Helmet
Naramon转换核心=Naramon Transmute Core
Naramon极性MOD=Naramon Mods
Mesa的华尔兹=Mesa's Waltz
Maroo的市集=Maroo's Bazaar
Madurai转换核心=Madurai Transmute Core
Madurai极性MOD=Madurai Mods
MOD包=Mod Pack
MOD=Mods 2.0
MOD=Mods
MOD=Mod
MK1-苦无=MK1-Kunai
MK1-盗贼=MK1-Furis
MK1-玻之武杖=MK1-Bo
MK1-斯特朗=MK1-Strun
MK1-弗拉克斯=MK1-Furax
MK1-帕里斯=MK1-Paris
MK1-布莱顿=MK1-Braton
Lotus的赏赐=Gift Of The Lotus
Lotus的指引者=Guides of the Lotus
Loki无赖外观=Loki Knave Skin
Limbo诗人头盔=Limbo Aristeas Helmet
Limbo画家头盔=Limbo Magrite Helmet
Limbo定理=The Limbo Theorem
Limbo定理=Limbo Theorem
Limbo奥雷奥路斯头盔=Limbo Aureolus Helmet
Lech=Lieutenant Lech KrilKril中尉
Lech=Lech KrilKril中尉
Kavor叛逃者=Kavor Defector
Jordas魔像=Jordas Golem
Jordas的审判=the Jordas Verdict
Jordas枢律=The Jordas Precept
Infested飞船（Archwing）=Infested Ship (Archwing)
Infested飞船=Infested Ship
Infested资源回收=Infested Salvage
Infested肿瘤=Infested Tumor
Infested护卫舰=Infested Frigate
Inaros之沙=Sands of Inaros
Hydroid海之信使头盔=Triton Hydroid Helmet
Helminth狩猎=Helminth Hunt
Harrow的枷锁=Chains of Harrow
Grustrag枷锁解除器=Grustrag Bolt Release
Grustrag枷锁=Grustrag Bolt
Grustrag三霸=the Grustrag Three
Grineer通报者=Informant Event
Grineer语=Grineer Language
Grineer营地=Grineer Settlement
Grineer船坞=Grineer Shipyard
Grineer能量运送者=Grineer Power Carrier
Grineer突击组合包=Grineer Desert Tactics Pack
Grineer目标=Grineer Target
Grineer深海研究所=Grineer Sealab
Grineer巨舰=Grineer Galleon
Grineer工人=Grineer Worker
Grineer小行星要塞=Grineer Asteroid Fortress
Grineer小行星=Grineer Asteroid
Grineer双子女皇=Grineer Queens
Grineer典狱长=Grineer Warden
Grineer丛林=Grineer Forest
Glast的千钧一策=The Glast Gambit
Frost寒地牛怪外观=Frost Harka Skin
Forma蓝图=Forma Blueprint
Ember复燃头盔=Backdraft Ember Helmet
Ember凤凰头盔=Phoenix Ember Helmet
Dex达克拉双剑=Dex Dakra
Dex盗贼双枪=Dex Furis
Dex席芭莉丝=Dex Sybaris
DNA稳定剂套装=DNA Stabilizer
Corpus飞船（Archwing）=Corpus Ship (Archwing)
Corpus飞船=Corpus Ship
Corpus语=Corpus Language
Corpus能量运送者=Corpus Power Carrier
Corpus目标=Corpus Target
Corpus燃气城市=Corpus Gas City
Corpus技师=Corpus Tech
Corpus战壕追逐=Corpus Trench Run
Corpus哨站=Corpus Outpost
Corpus冰原星球=Corpus Ice Planet
Corpus典狱长=Corpus Warden
Chroma龙蛇头盔=Drac Chroma Helmet
Chroma羽蛇神头盔=Amaru Chroma Helmet
Captura摄像棚=Captura Mode
Baro=Baro Ki'Teer OfferingKi'Teer商品
Baro=Baro Ki'Teer NoggleKi'Teer摇头娃娃
Banshee返响头盔=Reverb Banshee Helmet
Banshee女高音外观=Banshee Soprana Skin
Banshee合音头盔=Chorus Banshee Helmet
Atlas炼狱头盔=Atlas Tartarus Helmet
Atlas兜围头盔=Atlas Shikoro Helmet
Ash飞蝗头盔=Locust Ash Helmet
Ash甲贺外观=Ash Koga Skin
Ash毒蝎头盔=Scorpion Ash Helmet
Archwing（系列任务）=The Archwing
Archwing近战MOD=Archwing Melee Mods
Archwing近战=Archwing Melee
Archwing武器=Archwing Weapons
Archwing枪械MOD=Archwing Gun Mods
Archwing枪械=Archwing Gun
Archwing机体MOD=Archwing Mods
Archwing敌人=Archwing Enemies
Archwing操控=Archwing Maneuvers
Archwing技能=Archwing Abilities
神盾赋能=Arcane Aegiss
灵敏赋能=Arcane Agilitys
蜘蛛赋能=Arcane Arachnes
觉醒赋能=Arcane Awakenings
壁垒赋能=Arcane Barriers
结果赋能=Arcane Consequences
偏折赋能=Arcane Deflections
爆发赋能=Arcane Eruptions
狂怒赋能=Arcane Furys
保卫者赋能=Arcane Guardians
优雅赋能=Arcane Graces
复原赋能=Arcane Healings
冰冷赋能=Arcane Ices
消磁赋能=Arcane Nullifiers
动量赋能=Arcane Momentums
幻象赋能=Arcane Phantasms
精确赋能=Arcane Precisions
愤怒赋能=Arcane Rages
电阻赋能=Arcane Resistances
速攻赋能=Arcane Strikes
节奏赋能=Arcane Tempos
通牒赋能=Arcane Ultimatums
胜利赋能=Arcane Victorys
迅速赋能=Arcane Velocity
抵消正义=Neutralizing Justice
飓风海怪=Cyclone Kraken
ASHP=Ash Prime
ASHp=Ash Prime
ASH=Ash Prime
ash=Ash Prime
ashp=Ash Prime
ashP=Ash Prime
阿屎=Ash Prime
阿屎Prime头部=Ash Prime Neuroptics
阿屎Prime机体=Ash Prime Chassis
阿屎Prime总图=Ash Prime Blueprint
阿屎Prime系统=Ash Prime Systems
忍者=Ash Prime
忍者Prime头部=Ash Prime Neuroptics
忍者Prime机体=Ash Prime Chassis
忍者Prime总图=Ash Prime Blueprint
忍者Prime系统=Ash Prime Systems
阿屎PPrime=Ash Prime
阿屎P头部=Ash Prime Neuroptics
阿屎P机体=Ash Prime Chassis
阿屎P总图=Ash Prime Blueprint
阿屎P系统=Ash Prime Systems
忍者PPrime=Ash Prime
忍者P头部=Ash Prime Neuroptics
忍者P机体=Ash Prime Chassis
忍者P总图=Ash Prime Blueprint
忍者P系统=Ash Prime Systems
阿屎pPrime=Ash Prime
阿屎p头部=Ash Prime Neuroptics
阿屎p机体=Ash Prime Chassis
阿屎p总图=Ash Prime Blueprint
阿屎p系统=Ash Prime Systems
忍者pPrime=Ash Prime
忍者p头部=Ash Prime Neuroptics
忍者p机体=Ash Prime Chassis
忍者p总图=Ash Prime Blueprint
忍者p系统=Ash Prime Systems
阿屎=Ash Prime
阿屎prime头部=Ash Prime Neuroptics
阿屎prime机体=Ash Prime Chassis
阿屎prime总图=Ash Prime Blueprint
阿屎prime系统=Ash Prime Systems
忍者=Ash Prime
忍者prime头部=Ash Prime Neuroptics
忍者prime机体=Ash Prime Chassis
忍者prime总图=Ash Prime Blueprint
忍者prime系统=Ash Prime Systems
音妈=Banshee Prime
音妈Prime总图=Banshee Prime Blueprint
音妈Prime机体=Banshee Prime Chassis
音妈Prime系统=Banshee Prime Systems
音妈Prime头部=Banshee Prime Neuroptics
音妈=Banshee Prime
音妈prime总图=Banshee Prime Blueprint
音妈prime机体=Banshee Prime Chassis
音妈prime系统=Banshee Prime Systems
音妈prime头部=Banshee Prime Neuroptics
音妈P=Banshee Prime
音妈P总图=Banshee Prime Blueprint
音妈P机体=Banshee Prime Chassis
音妈P系统=Banshee Prime Systems
音妈P头部=Banshee Prime Neuroptics
音妈P=Banshee Prime
音妈p总图=Banshee Prime Blueprint
音妈p机体=Banshee Prime Chassis
音妈p系统=Banshee Prime Systems
音妈p头部=Banshee Prime Neuroptics
火鸡=Ember Prime
火鸡Prime机体=Ember Prime Chassis
火鸡Prime总图=Ember Prime Blueprint
火鸡Prime系统=Ember Prime Systems
火鸡Prime头部=Ember Prime Neuroptics
火鸡p=Ember Prime
火鸡prime机体=Ember Prime Chassis
火鸡prime总图=Ember Prime Blueprint
火鸡prime系统=Ember Prime Systems
火鸡prime头部=Ember Prime Neuroptics
火鸡P=Ember Prime
火鸡P机体=Ember Prime Chassis
火鸡P总图=Ember Prime Blueprint
火鸡P系统=Ember Prime Systems
火鸡P头部=Ember Prime Neuroptics
冰男=Frost Prime
冰男Prime总图=Frost Prime Blueprint
冰男Prime系统=Frost Prime Systems
冰男Prime头部=Frost Prime Neuroptics
冰男Prime机体=Frost Prime Chassis
冰男=Frost Prime
冰男prime总图=Frost Prime Blueprint
冰男prime系统=Frost Prime Systems
冰男prime头部=Frost Prime Neuroptics
冰男prime机体=Frost Prime Chassis
冰队=Frost Prime
冰队Prime总图=Frost Prime Blueprint
冰队Prime系统=Frost Prime Systems
冰队Prime头部=Frost Prime Neuroptics
冰队Prime机体=Frost Prime Chassis
冰男P=Frost Prime
冰男P总图=Frost Prime Blueprint
冰男P系统=Frost Prime Systems
冰男P头部=Frost Prime Neuroptics
冰男P机体=Frost Prime Chassis
冰队P=Frost Prime
冰队P总图=Frost Prime Blueprint
冰队P系统=Frost Prime Systems
冰队P头部=Frost Prime Neuroptics
冰队P机体=Frost Prime Chassis
冰男p=Frost Prime
冰男p总图=Frost Prime Blueprint
冰男p系统=Frost Prime Systems
冰男p头部=Frost Prime Neuroptics
冰男p机体=Frost Prime Chassis
冰队p=Frost Prime
冰队p总图=Frost Prime Blueprint
冰队p系统=Frost Prime Systems
冰队p头部=Frost Prime Neuroptics
冰队p机体=Frost Prime Chassis
洛基=Loki Prime
洛基Prime总图=Loki Prime Blueprint
洛基Prime机体=Loki Prime Chassis
洛基Prime系统=Loki Prime Systems
洛基Prime头部=Loki Prime Neuroptics
洛基p=Loki Prime
洛基prime总图=Loki Prime Blueprint
洛基prime机体=Loki Prime Chassis
洛基prime系统=Loki Prime Systems
洛基prime头部=Loki Prime Neuroptics
洛基P=Loki Prime
洛基P总图=Loki Prime Blueprint
洛基P机体=Loki Prime Chassis
洛基P系统=Loki Prime Systems
洛基P头部=Loki Prime Neuroptics
磁妹=Mag Prime
磁妹Prim总图=Mag Prime Blueprint
磁妹Prim系统=Mag Prime Systems
磁妹Prim机体=Mag Prime Chassis
磁妹Prim头部=Mag Prime Neuroptics
MAG=Mag Prime
MAGp=Mag Prime
MAGP=Mag Prime
剑风p=Primed Reach
剑风P=Primed Reach
摸尸p=Nekros Prime
毒妈=Saryn Prime
套装=Set
小丑=Mirage Prime
小丑p=Mirage Prime
小丑P=Mirage Prime
摸=Nekros Prime
摸尸=Nekros Prime
摸尸P=Nekros Prime
致残=Maiming Strike
牛p=Rhino Prime
犀牛=Rhino Prime
犀牛p=Rhino Prime
犀牛P=Rhino Prime
牛P=Rhino Prime
音妈p=Banshee Prime
压迫=Primed Pressure Point
压迫p=Primed Pressure Point
侍刃p=Nikana Prime
席瓦神盾=Silva & Aegis Prime
席瓦&神盾=Silva & Aegis Prime
女汉子=Valkyr Prime
瓦尔基里=Valkyr Prime
女汉子p=Valkyr Prime
女汉子P=Valkyr Prime
瓦尔基里p=Valkyr Prime
瓦尔基里P=Valkyr Prime
瓦喵P=Valkyr Prime
女妖P=Banshee  Prime
Nova=Nova Prime
nova=Nova Prime
持久p=Primed Continuity
持久力p=Primed Continuity
猛虎p=Tigris Prime
猛虎P=Tigris Prime
月神p=Soma Prime
月神P=Soma Prime
持久=Continuity
持久力P=Primed Continuity
